%%%%%%%%%%%%%%%%%%%%%%%%%%%%
%..........................%
%.%%.%%%%.%%%%%%%%.%%%%.%%.%
%.%%.%  %.%%%%%%%%.%  %.%%.%
%.%%.%%%%.%%....%%.%%%%.%%.%
%o%%......%%.%%.%%......%%o%
%.%%%%.%%.%%.%%.%%.%%.%%%%.%
%.%%%%.%%.%%.%%.%%.%%.%%%%.%
%.%%...%%....%%....%%...%%.%
%.%%.%%%%.%%%%%%%%.%%%%.%%.%
%.%%.%%%%.%%%%%%%%.%%%%.%%.%
%..........................%
%%%%%%.%%.%%%  %%%.%%.%%%%%%
%    %.%%.%      %.%%.%    %
%    %.%%.%  GG  %.%%.%    %
%    %.%%.%      %.%%.%    %
%  %%%.%%.%%%%%%%%.%%.%%%  %
%  %...%%..........%%...%  %
%  %.%%%%%%%.%%.%%%%%%%.%  %
%%%%.%%%%%%%.%%.%%%%%%%.%%%%
%   .........%%.........   %
%%%%.%%%%%.%%%%%%.%%%%%.%%%%
%%%%.%%%%%.%%%%%%.%%%%%.%%%%
%....%%..............%%....%
%.%%.%%.%%.%%%%%%.%%.%%.%%.%
%.%%.%%.%%.%%%%%%.%%.%%.%%.%
%.%%....%%...%%...%%....%%.%
%o%%%%%.%%%%.%%.%%%%.%%%%%o%
%.%%%%%.%%%%.%%.%%%%.%%%%%.%
%............P.............%
%%%%%%%%%%%%%%%%%%%%%%%%%%%%