%%%%%%%%%%%%%%%%%%%%%%%%%%%%%%%
%............%%%%%............%
%%%.%...%%%....G....%.%...%.%%%
%...%%%.%.%%%%.%.%%%%%%.%%%...%
%.%.....%......%......%.....%.%
%.%%%.%%%%%.%%%%%%%.%%%.%.%%%%%
%.....%........P....%...%.....%
%%%%%%%%%%%%%%%%%%%%%%%%%%%%%%%
