%%%%%%%%%%%%%%%%%%%%%%%%%%%%
%.                        .%
% %%%%%%% %%%%%%%% %%%%%%% %
% %%%%%%% %%%%%%%% %%%%%%% %
%   %%    %%    %%    %%   %
%%% %% %% %% %% %% %% %% %%%
% % %% %% %% %% %% %% %% % %
%%% %% %% %% %% %% %% %% %%%
%      %%    %%    %%      %
%%% %%%%% %%%%%%%% %%%%% %%%
%%% %%%%% %%%%%%%% %%%%% %%%
%                          %
% %%%%%%% %%%  %%% %%%%%%% %
% %%%%%%% %      % %%%%%%% %
%   %%    %      %    %%   %
%%% %% %% %      % %% %% %%%
%%% %% %% %%%%%%%% %% %% %%%
%      %%          %%      %
% %%%%%%%%%% %% %%%%%%%%%% %
% %%%%%%%%%% %% %%%%%%%%%% %
%            %%            %
%%%%%% %% %%%%%%%% %% %%%%%%
%%%%%% %% %%%%%%%% %% %%%%%%
%      %%          %%      %
% %% %%%%%%% %% %%%%%%% %% %
% %% %%%%%%% %% %%%%%%% %% %
% %%         %%         %% %
% %%%%% %% %%%%%% %% %%%%% %
% %%%%% %% %%%%%% %% %%%%% %
%.      %%   P    %%      .%
%%%%%%%%%%%%%%%%%%%%%%%%%%%%