%%%%%%%%%%%%%%%%%%%%%%%%%%%%
%.           %%           .%
% %%%% %%%%% %% %%%%% %%%% %
% %  % %   % %% %   % %  % %
% %%%% %%%%% %% %%%%% %%%% %
%            %%            %
% %% %%%% %%%%%%%% %%%% %% %
% %% %%%% %%%%%%%% %%%% %% %
% %%   %%          %%   %% %
% %%%% %% %%%%%%%% %% %%%% %
% %%%% %% %%%%%%%% %% %%%% %
% %%                    %% %
% %% %%%% %%%  %%% %%%% %% %
% %% %%%% %      % %%%% %% %
%      %% %      % %%      %
% %%%% %% %      % %% %%%% %
% %%%% %% %%%%%%%% %% %%%% %
% %%                    %% %
% %% %%%% %%%%%%%% %%%% %% %
% %% %%%% %%%%%%%% %%%% %% %
%      %%    %%    %%      %
% %%%% %% %% %% %% %% %%%% %
% %%%% %% %% %% %% %% %%%% %
% %%      %%    %%      %% %
% %% %%%%%%% %% %%%%%%% %% %
% %% %%%%%%% %% %%%%%%% %% %
%            %%            %
% %%%%% %% %%%%%% %% %%%%% %
% %%%%% %% %%%%%% %% %%%%% %
%.      %%   P    %%      .%
%%%%%%%%%%%%%%%%%%%%%%%%%%%%