%%%%%%%%%%%%%%%%%%%%%%%%%%%%
%.                        .%
% %%%% %% %%%%%%%% %% %%%% %
% %  % %% %%%%%%%% %% %  % %
% %%%% %% %%    %% %% %%%% %
%      %% %% %% %% %%      %
% %%%%%%% %% %% %% %%%%%%% %
% %%%%%%% %% %% %% %%%%%%% %
%            %%            %
% %%%% %% %%%%%%%% %% %%%% %
% %%%% %% %%%%%%%% %% %%%% %
% %%   %%          %%   %% %
% %% %%%% %%%  %%% %%%% %% %
% %% %%%% %      % %%%% %% %
%         %      %         %
%%%%%% %% %      % %% %%%%%%
%%%%%% %% %%%%%%%% %% %%%%%%
%      %%          %%      %
% %% %%%%%%% %% %%%%%%% %% %
% %% %%%%%%% %% %%%%%%% %% %
% %%         %%         %% %
% %%%% %% %%%%%%%% %% %%%% %
% %%%% %% %%%%%%%% %% %%%% %
% %%   %%          %%   %% %
% %% %%%% %%%%%%%% %%%% %% %
% %% %%%% %%%%%%%% %%%% %% %
%      %% %%    %% %%      %
% %%%% %% %% %% %% %% %%%% %
% %%%% %% %% %% %% %% %%%% %
%.           P            .%
%%%%%%%%%%%%%%%%%%%%%%%%%%%%