%%%%%%%%%%%%%%%%%%%%%%%%%%%%
%.                        .%
% %%%%%%%%%% %% %%%%%%%%%% %
% %%%%%%%%%% %% %%%%%%%%%% %
%      %%    %%    %%      %
%%%%%% %% %%%%%%%% %% %%%%%%
%%%%%% %% %%%%%%%% %% %%%%%%
%   %%                %%   %
%%% %% %% %%%%%%%% %% %% %%%
% % %% %% %      % %% %% % %
% % %% %% %%%%%%%% %% %% % %
% %    %%          %%    % %
% % %%%%% %%%  %%% %%%%% % %
%%% %%%%% %      % %%%%% %%%
%         %      %         %
% %%%% %% %      % %% %%%% %
% %%%% %% %%%%%%%% %% %%%% %
% %%   %%          %%   %% %
% %% %%%%%%% %% %%%%%%% %% %
% %% %%%%%%% %% %%%%%%% %% %
%      %%    %%    %%      %
%%%%%% %% %%%%%%%% %% %%%%%%
%%%%%% %% %%%%%%%% %% %%%%%%
%   %%                %%   %
%%% %% %%%%% %% %%%%% %% %%%
%%% %% %%%%% %% %%%%% %% %%%
%            %%            %
% %%%% %% %%%%%%%% %% %%%% %
% %%%% %% %%%%%%%% %% %%%% %
%.     %%    P     %%     .%
%%%%%%%%%%%%%%%%%%%%%%%%%%%%