%%%%%%%%%%%%%%%%%%%%%%%%%%%%
%.                        .%
% %% %%%% %%%%%%%% %%%% %% %
% %% %%%% %%%%%%%% %%%% %% %
% %%   %%    %%    %%   %% %
% %%%% %% %% %% %% %% %%%% %
% %%%% %% %% %% %% %% %%%% %
%         %% %% %%         %
%%% %%%%% %%    %% %%%%% %%%
% % %%%%% %%%%%%%% %%%%% % %
% %    %% %%%%%%%% %%    % %
% % %% %%          %% %% % %
% % %% %% %%%  %%% %% %% % %
%%% %% %% %      % %% %% %%%
%   %%    %      %    %%   %
% %%%%%%% %      % %%%%%%% %
% %%%%%%% %%%%%%%% %%%%%%% %
%                          %
% %%%% %% %%%%%%%% %% %%%% %
% %%%% %% %%%%%%%% %% %%%% %
%   %% %%    %%    %% %%   %
%%% %% %%%%% %% %%%%% %% %%%
%%% %% %%%%% %% %%%%% %% %%%
%      %%          %%      %
%%% %% %% %%%%%%%% %% %% %%%
%%% %% %% %%%%%%%% %% %% %%%
%   %% %% %%    %% %% %%   %
% %%%% %% %% %% %% %% %%%% %
% %%%% %% %% %% %% %% %%%% %
%.           P            .%
%%%%%%%%%%%%%%%%%%%%%%%%%%%%