%%%%%%%%%%%%%%%%%%%%%%%%%%%%
%.                        .%
% %%%% %% %%%%%%%% %% %%%% %
% %%%% %% %%%%%%%% %% %%%% %
% %%   %% %%    %% %%   %% %
% %% %%%% %% %% %% %%%% %% %
% %% %%%% %% %% %% %%%% %% %
%      %% %% %% %% %%      %
% %%%% %%    %%    %% %%%% %
% %  % %% %%%%%%%% %% %  % %
% %%%% %% %%%%%%%% %% %%%% %
%                          %
%%%% %%%% %%%  %%% %%%% %%%%
%  % %  % %      % %  % %  %
%  % %  % %      % %  % %  %
%  % %  % %      % %  % %  %
%  % %%%% %%%%%%%% %%%% %  %
%  %                    %  %
%  % %%%% %%%%%%%% %%%% %  %
%  % %%%% %%%%%%%% %%%% %  %
%  %         %%         %  %
%  % %%%%%%% %% %%%%%%% %  %
%%%% %%%%%%% %% %%%%%%% %%%%
%    %%              %%    %
%%%% %% %% %%%%%% %% %% %%%%
%%%% %% %% %%%%%% %% %% %%%%
%       %%   %%   %%       %
% %%%%% %%%% %% %%%% %%%%% %
% %%%%% %%%% %% %%%% %%%%% %
%.           P            .%
%%%%%%%%%%%%%%%%%%%%%%%%%%%%