%%%%%%%%%%%%%%%%%%%%%%%%%%%%
%.     %%          %%     .%
% %%%% %% %%%%%%%% %% %%%% %
% %%%% %% %%%%%%%% %% %%%% %
% %%      %%    %%      %% %
% %% %%%% %% %% %% %%%% %% %
% %% %  % %% %% %% %  % %% %
% %% %%%% %% %% %% %%%% %% %
%            %%            %
% %% %%%% %%%%%%%% %%%% %% %
% %% %%%% %%%%%%%% %%%% %% %
% %%   %%          %%   %% %
% %%%% %% %%%  %%% %% %%%% %
% %%%% %% %      % %% %%%% %
%         %      %         %
%%% %% %% %      % %% %% %%%
%%% %% %% %%%%%%%% %% %% %%%
%   %% %%          %% %%   %
% %%%% %%%%% %% %%%%% %%%% %
% %%%% %%%%% %% %%%%% %%%% %
%      %%    %%    %%      %
%%%%%% %% %%%%%%%% %% %%%%%%
%%%%%% %% %%%%%%%% %% %%%%%%
%   %%                %%   %
%%% %% %% %%%%%%%% %% %% %%%
%%% %% %% %%%%%%%% %% %% %%%
%      %% %%    %% %%      %
% %%%%%%% %% %% %% %%%%%%% %
% %%%%%%% %% %% %% %%%%%%% %
%.           P            .%
%%%%%%%%%%%%%%%%%%%%%%%%%%%%