%%%%%%%%%%%%%%%%%%%%%%%%%%%%
%.                        .%
% %%%% %% %%%%%%%% %% %%%% %
% %%%% %% %%%%%%%% %% %%%% %
% %%   %%    %%    %%   %% %
% %% %%%% %% %% %% %%%% %% %
% %% %%%% %% %% %% %%%% %% %
%         %% %% %%         %
% %%%% %% %%    %% %% %%%% %
% %  % %% %%%%%%%% %% %  % %
% %%%% %% %%%%%%%% %% %%%% %
%      %%          %%      %
% %%%%%%% %%%  %%% %%%%%%% %
% %%%%%%% %      % %%%%%%% %
%         %      %         %
% %%%%%%% %      % %%%%%%% %
% %%%%%%% %%%%%%%% %%%%%%% %
%   %%                %%   %
%%% %% %%%%% %% %%%%% %% %%%
%%% %% %%%%% %% %%%%% %% %%%
%         %% %% %%         %
% %%%% %% %% %% %% %% %%%% %
% %%%% %% %% %% %% %% %%%% %
%   %% %%          %% %%   %
%%% %% %%%%% %% %%%%% %% %%%
%%% %% %%%%% %% %%%%% %% %%%
%            %%            %
% %%%% %% %%%%%%%% %% %%%% %
% %%%% %% %%%%%%%% %% %%%% %
%.     %%    P     %%     .%
%%%%%%%%%%%%%%%%%%%%%%%%%%%%