%%%%%%%%%%%%%%%%%%%%%%%%%%%%
%.                        .%
% %% %%%% %%%%%%%% %%%% %% %
% %% %%%% %%%%%%%% %%%% %% %
% %%   %%    %%    %%   %% %
% %%%% %% %% %% %% %% %%%% %
% %%%% %% %% %% %% %% %%%% %
%         %% %% %%         %
%%%% %%%% %%    %% %%%% %%%%
%  % %  % %%%%%%%% %  % %  %
%%%% %%%% %%%%%%%% %%%% %%%%
%                          %
% %%%%%%% %%%  %%% %%%%%%% %
% %%%%%%% %      % %%%%%%% %
%   %%    %      %    %%   %
%%% %% %% %      % %% %% %%%
%%% %% %% %%%%%%%% %% %% %%%
%      %%          %%      %
%%% %% %% %%%%%%%% %% %% %%%
%%% %% %% %%%%%%%% %% %% %%%
%   %% %%    %%    %% %%   %
% %%%% %%%%% %% %%%%% %%%% %
% %%%% %%%%% %% %%%%% %%%% %
%                          %
% %% %%%% %%%%%%%% %%%% %% %
% %% %%%% %%%%%%%% %%%% %% %
% %%   %% %%    %% %%   %% %
% %%%% %% %% %% %% %% %%%% %
% %%%% %% %% %% %% %% %%%% %
%.           P            .%
%%%%%%%%%%%%%%%%%%%%%%%%%%%%