%%%%%%%%%%%%%%%%%%%%%%%%%%%%
%.     %%          %%     .%
% %%%% %% %%%%%%%% %% %%%% %
% %%%% %% %%%%%%%% %% %%%% %
%   %%       %%       %%   %
%%% %% %% %% %% %% %% %% %%%
%%% %% %% %% %% %% %% %% %%%
%      %% %% %% %% %%      %
%%% %%%%% %%    %% %%%%% %%%
% % %%%%% %%%%%%%% %%%%% % %
% %    %% %%%%%%%% %%    % %
% % %% %%          %% %% % %
% % %% %% %%%  %%% %% %% % %
%%% %% %% %      % %% %% %%%
%   %%    %      %    %%   %
% %%%%%%% %      % %%%%%%% %
% %%%%%%% %%%%%%%% %%%%%%% %
%                          %
%%% %%%%%%%% %% %%%%%%%% %%%
% % %%%%%%%% %% %%%%%%%% % %
% % %%       %%       %% % %
% % %% %% %%%%%%%% %% %% % %
%%% %% %% %%%%%%%% %% %% %%%
%      %%          %%      %
%%% %% %%%%% %% %%%%% %% %%%
%%% %% %%%%% %% %%%%% %% %%%
%   %% %%    %%    %% %%   %
% %%%% %% %%%%%%%% %% %%%% %
% %%%% %% %%%%%%%% %% %%%% %
%.           P            .%
%%%%%%%%%%%%%%%%%%%%%%%%%%%%