%%%%%%%%%%%%%%%%%%%%%%%%%%%%
%.     %%          %%     .%
% %%%% %% %%%%%%%% %% %%%% %
% %%%% %% %%%%%%%% %% %%%% %
% %%   %%    %%    %%   %% %
% %% %%%% %% %% %% %%%% %% %
% %% %%%% %% %% %% %%%% %% %
%         %% %% %%         %
%%%%%% %% %%    %% %% %%%%%%
%    % %% %%%%%%%% %% %    %
%    % %% %%%%%%%% %% %    %
%    % %%          %% %    %
%    % %% %%%  %%% %% %    %
%%%%%% %% %      % %% %%%%%%
%      %% %      % %%      %
%%% %%%%% %      % %%%%% %%%
% % %%%%% %%%%%%%% %%%%% % %
% %                      % %
% % %% %% %%%%%%%% %% %% % %
%%% %% %% %%%%%%%% %% %% %%%
%   %% %%    %%    %% %%   %
% %%%% %%%%% %% %%%%% %%%% %
% %%%% %%%%% %% %%%%% %%%% %
%      %%          %%      %
%%% %% %% %%%%%%%% %% %% %%%
%%% %% %% %%%%%%%% %% %% %%%
%   %%       %%       %%   %
% %%%%%%% %% %% %% %%%%%%% %
% %%%%%%% %% %% %% %%%%%%% %
%.        %% P  %%        .%
%%%%%%%%%%%%%%%%%%%%%%%%%%%%