%%%%%%%%%%%%%%%%%%%%%%%%%%%%
%.           %%           .%
% %%%%% %%%% %% %%%% %%%%% %
% %%%%% %%%% %% %%%% %%%%% %
% %%    %%        %%    %% %
% %% %% %% %%%%%% %% %% %% %
% %% %% %% %%%%%% %% %% %% %
%    %%      %%      %%    %
%%%% %% %%%% %% %%%% %% %%%%
%  % %% %  % %% %  % %% %  %
%%%% %% %%%% %% %%%% %% %%%%
%    %%              %%    %
% %% %%%% %%%  %%% %%%% %% %
% %% %%%% %      % %%%% %% %
% %%      %      %      %% %
% %%%% %% %      % %% %%%% %
% %%%% %% %%%%%%%% %% %%%% %
% %%   %%          %%   %% %
% %% %%%% %%%%%%%% %%%% %% %
% %% %%%% %%%%%%%% %%%% %% %
%      %%    %%    %%      %
%%%%%% %% %% %% %% %% %%%%%%
%%%%%% %% %% %% %% %% %%%%%%
%   %%    %%    %%    %%   %
%%% %% %%%%% %% %%%%% %% %%%
%%% %% %%%%% %% %%%%% %% %%%
%            %%            %
% %%%% %% %%%%%%%% %% %%%% %
% %%%% %% %%%%%%%% %% %%%% %
%.     %%    P     %%     .%
%%%%%%%%%%%%%%%%%%%%%%%%%%%%