%%%%%%%%%%%%%%%%%%%%%%%%%%%%
%.           %%           .%
% %%%% %%%%% %% %%%%% %%%% %
% %%%% %%%%% %% %%%%% %%%% %
% %%      %% %% %%      %% %
% %% %%%% %%    %% %%%% %% %
% %% %%%% %% %% %% %%%% %% %
%      %% %% %% %% %%      %
% %%%% %%    %%    %% %%%% %
% %  % %% %%%%%%%% %% %  % %
% %%%% %% %%%%%%%% %% %%%% %
%                          %
% %%%% %% %%%  %%% %% %%%% %
% %%%% %% %      % %% %%%% %
%   %% %% %      % %% %%   %
%%% %% %% %      % %% %% %%%
% % %% %% %%%%%%%% %% %% % %
% %    %%          %%    % %
% % %% %%%%% %% %%%%% %% % %
%%% %% %%%%% %% %%%%% %% %%%
%   %%       %%       %%   %
% %%%%%%% %%%%%%%% %%%%%%% %
% %%%%%%% %%%%%%%% %%%%%%% %
%                          %
%%%% %% %%%% %% %%%% %% %%%%
%%%% %% %%%% %% %%%% %% %%%%
%    %% %%   %%   %% %%    %
% %%%%% %% %%%%%% %% %%%%% %
% %%%%% %% %%%%%% %% %%%%% %
%.           P            .%
%%%%%%%%%%%%%%%%%%%%%%%%%%%%