%%%%%%%%%%%%%%%%%%%%%%%%%%%%
%.                        .%
% %% %%%% %%%%%%%% %%%% %% %
% %% %%%% %%%%%%%% %%%% %% %
% %%   %%    %%    %%   %% %
% %%%% %% %% %% %% %% %%%% %
% %%%% %% %% %% %% %% %%%% %
%         %% %% %%         %
% %% %%%% %%    %% %%%% %% %
% %% %%%% %%%%%%%% %%%% %% %
% %%   %% %%%%%%%% %%   %% %
% %%%% %%          %% %%%% %
% %%%% %% %%%  %%% %% %%%% %
%         %      %         %
%%%% %%%% %      % %%%% %%%%
%%%% %%%% %      % %%%% %%%%
%      %% %%%%%%%% %%      %
% %%%% %%          %% %%%% %
% %%%% %% %%%%%%%% %% %%%% %
%   %% %% %%%%%%%% %% %%   %
%%% %%       %%       %% %%%
% % %% %%%%% %% %%%%% %% % %
%%% %% %%%%% %% %%%%% %% %%%
%         %%    %%         %
% %%%%%%% %% %% %% %%%%%%% %
% %%%%%%% %% %% %% %%%%%%% %
%      %%    %%    %%      %
% %%%% %% %%%%%%%% %% %%%% %
% %%%% %% %%%%%%%% %% %%%% %
%.           P            .%
%%%%%%%%%%%%%%%%%%%%%%%%%%%%