%%%%%%%%%%%%%%%%%%%%%%%%%%%%
%.        %%    %%        .%
% %%%%%%% %% %% %% %%%%%%% %
% %%%%%%% %% %% %% %%%%%%% %
%   %%       %%       %%   %
%%% %% %% %%%%%%%% %% %% %%%
%%% %% %% %%%%%%%% %% %% %%%
%      %%          %%      %
% %%%% %% %%%%%%%% %% %%%% %
% %%%% %% %      % %% %%%% %
%   %% %% %%%%%%%% %% %%   %
%%% %%                %% %%%
% % %% %% %%%  %%% %% %% % %
%%% %% %% %      % %% %% %%%
%      %% %      % %%      %
%%% %%%%% %      % %%%%% %%%
%%% %%%%% %%%%%%%% %%%%% %%%
%                          %
% %%%%%%%%%% %% %%%%%%%%%% %
% %%%%%%%%%% %% %%%%%%%%%% %
%       %%   %%   %%       %
% %%%%% %% %%%%%% %% %%%%% %
% %%%%% %% %%%%%% %% %%%%% %
%    %%              %%    %
% %% %% %%%% %% %%%% %% %% %
% %% %% %%%% %% %%%% %% %% %
% %%    %%   %%   %%    %% %
% %%%%% %% %%%%%% %% %%%%% %
% %%%%% %% %%%%%% %% %%%%% %
%.           P            .%
%%%%%%%%%%%%%%%%%%%%%%%%%%%%