%%%%%%%%%%%%%%%%%%%%%%%%%%%%
%.                        .%
% %% %%%% %%%%%%%% %%%% %% %
% %% %  % %      % %  % %% %
% %% %%%% %%%%%%%% %%%% %% %
% %%                    %% %
% %%%% %% %%%%%%%% %% %%%% %
% %%%% %% %%%%%%%% %% %%%% %
%      %%    %%    %%      %
% %%%%%%%%%% %% %%%%%%%%%% %
% %%%%%%%%%% %% %%%%%%%%%% %
%                          %
%%% %%%%% %%%  %%% %%%%% %%%
%%% %%%%% %      % %%%%% %%%
%      %% %      % %%      %
% %%%% %% %      % %% %%%% %
% %%%% %% %%%%%%%% %% %%%% %
%   %%                %%   %
%%% %% %%%%% %% %%%%% %% %%%
%%% %% %%%%% %% %%%%% %% %%%
%      %%    %%    %%      %
%%%%%% %% %%%%%%%% %% %%%%%%
%%%%%% %% %%%%%%%% %% %%%%%%
%                          %
% %% %%%% %%%%%%%% %%%% %% %
% %% %%%% %%%%%%%% %%%% %% %
% %%   %%    %%    %%   %% %
% %%%% %% %% %% %% %% %%%% %
% %%%% %% %% %% %% %% %%%% %
%.        %% P  %%        .%
%%%%%%%%%%%%%%%%%%%%%%%%%%%%