%%%%%%%%%%%%%%%%%%%%%%%%%%%%
%.                        .%
% %%%%%%% %%%%%%%% %%%%%%% %
% %%%%%%% %%%%%%%% %%%%%%% %
%      %%    %%    %%      %
% %%%% %% %% %% %% %% %%%% %
% %  % %% %% %% %% %% %  % %
% %  %    %% %% %%    %  % %
% %  % %% %%    %% %% %  % %
% %%%% %% %%%%%%%% %% %%%% %
%      %% %%%%%%%% %%      %
%%% %%%%%          %%%%% %%%
% % %%%%% %%%  %%% %%%%% % %
% %    %% %      % %%    % %
% % %% %% %      % %% %% % %
% % %% %% %      % %% %% % %
%%% %% %% %%%%%%%% %% %% %%%
%   %%                %%   %
%%%%%% %%%%% %% %%%%% %%%%%%
%%%%%% %%%%% %% %%%%% %%%%%%
%   %% %%    %%    %% %%   %
%%% %% %% %%%%%%%% %% %% %%%
% % %% %% %%%%%%%% %% %% % %
% %                      % %
% % %% %%%%% %% %%%%% %% % %
%%% %% %%%%% %% %%%%% %% %%%
%   %% %%    %%    %% %%   %
% %%%% %% %%%%%%%% %% %%%% %
% %%%% %% %%%%%%%% %% %%%% %
%.           P            .%
%%%%%%%%%%%%%%%%%%%%%%%%%%%%