%%%%%%%%%%%%%%%%%%%%%%%%%%%%
%.                        .%
% %%%% %% %%%%%%%% %% %%%% %
% %%%% %% %%%%%%%% %% %%%% %
%   %% %%    %%    %% %%   %
%%% %% %% %% %% %% %% %% %%%
% % %% %% %% %% %% %% %% % %
%%% %% %% %% %% %% %% %% %%%
%      %% %%    %% %%      %
%%% %%%%% %%%%%%%% %%%%% %%%
%%% %%%%% %%%%%%%% %%%%% %%%
%      %%          %%      %
% %%%% %% %%%  %%% %% %%%% %
% %%%% %% %      % %% %%%% %
%   %%    %      %    %%   %
%%% %% %% %      % %% %% %%%
% % %% %% %%%%%%%% %% %% % %
% %    %%          %%    % %
% % %%%%%%%% %% %%%%%%%% % %
% % %%%%%%%% %% %%%%%%%% % %
% %    %%    %%    %%    % %
% % %% %% %%%%%%%% %% %% % %
%%% %% %% %%%%%%%% %% %% %%%
%   %%                %%   %
% %%%% %%%%% %% %%%%% %%%% %
% %%%% %%%%% %% %%%%% %%%% %
%            %%            %
% %%%% %% %%%%%%%% %% %%%% %
% %%%% %% %%%%%%%% %% %%%% %
%.     %%    P     %%     .%
%%%%%%%%%%%%%%%%%%%%%%%%%%%%