%%%%%%%%%%%%%%%%%%%%%%%%%%%%
%.     %%          %%     .%
% %%%% %% %%%%%%%% %% %%%% %
% %%%% %% %%%%%%%% %% %%%% %
% %%         %%         %% %
% %% %%%% %% %% %% %%%% %% %
% %% %%%% %% %% %% %%%% %% %
%      %% %% %% %% %%      %
% %%%% %% %%    %% %% %%%% %
% %%%% %% %%%%%%%% %% %%%% %
%   %% %% %%%%%%%% %% %%   %
%%% %%                %% %%%
% % %% %% %%%  %%% %% %% % %
%%% %% %% %      % %% %% %%%
%      %% %      % %%      %
%%% %%%%% %      % %%%%% %%%
% % %%%%% %%%%%%%% %%%%% % %
% %                      % %
% % %% %%%%% %% %%%%% %% % %
%%% %% %%%%% %% %%%%% %% %%%
%   %% %%    %%    %% %%   %
% %%%% %% %%%%%%%% %% %%%% %
% %%%% %% %%%%%%%% %% %%%% %
%      %%          %%      %
%%% %% %% %%%%%%%% %% %% %%%
%%% %% %% %%%%%%%% %% %% %%%
%   %%       %%       %%   %
% %%%% %%%%% %% %%%%% %%%% %
% %%%% %%%%% %% %%%%% %%%% %
%.           P            .%
%%%%%%%%%%%%%%%%%%%%%%%%%%%%