%%%%%%%%%%%%%%%%%%%%%%%%%%%%
%.                        .%
% %%%% %% %%%%%%%% %% %%%% %
% %%%% %% %%%%%%%% %% %%%% %
% %%   %% %%    %% %%   %% %
% %% %%%% %% %% %% %%%% %% %
% %% %%%% %% %% %% %%%% %% %
%      %% %% %% %% %%      %
% %%%% %%    %%    %% %%%% %
% %%%% %% %%%%%%%% %% %%%% %
%   %% %% %%%%%%%% %% %%   %
%%% %%                %% %%%
% % %% %% %%%  %%% %% %% % %
% % %% %% %      % %% %% % %
% %    %% %      % %%    % %
% % %%%%% %      % %%%%% % %
% % %%%%% %%%%%%%% %%%%% % %
% %                      % %
% % %%%%%%%% %% %%%%%%%% % %
%%% %%%%%%%% %% %%%%%%%% %%%
%         %% %% %%         %
%%% %%%%% %% %% %% %%%%% %%%
% % %%%%% %% %% %% %%%%% % %
% % %%                %% % %
% % %% %% %%%%%%%% %% %% % %
%%% %% %% %%%%%%%% %% %% %%%
%      %%    %%    %%      %
% %%%% %%%%% %% %%%%% %%%% %
% %%%% %%%%% %% %%%%% %%%% %
%.           P            .%
%%%%%%%%%%%%%%%%%%%%%%%%%%%%