%%%%%%%%%%%%%%%%%%%%%%%%%%%%
%.                        .%
% %%%%%%% %%%%%%%% %%%%%%% %
% %%%%%%% %      % %%%%%%% %
%      %% %%%%%%%% %%      %
%%% %% %%          %% %% %%%
% % %% %% %%%%%%%% %% %% % %
%%% %% %% %%%%%%%% %% %% %%%
%   %%       %%       %%   %
% %%%% %%%%% %% %%%%% %%%% %
% %%%% %%%%% %% %%%%% %%%% %
%      %%          %%      %
%%% %% %% %%%  %%% %% %% %%%
% % %% %% %      % %% %% % %
% % %%    %      %    %% % %
% % %%%%% %      % %%%%% % %
%%% %%%%% %%%%%%%% %%%%% %%%
%   %%                %%   %
%%% %% %% %%%%%%%% %% %% %%%
% % %% %% %%%%%%%% %% %% % %
% %    %%    %%    %%    % %
% % %%%%%%%% %% %%%%%%%% % %
% % %%%%%%%% %% %%%%%%%% % %
% %    %%          %%    % %
% % %% %% %%%%%%%% %% %% % %
%%% %% %% %%%%%%%% %% %% %%%
%   %%       %%       %%   %
% %%%% %%%%% %% %%%%% %%%% %
% %%%% %%%%% %% %%%%% %%%% %
%.           P            .%
%%%%%%%%%%%%%%%%%%%%%%%%%%%%