%%%%%%%%%%%%%%%%%%%%%%%%%%%%
%.                        .%
% %%%% %% %%%%%%%% %% %%%% %
% %  % %% %%%%%%%% %% %  % %
% %%%% %%    %%    %% %%%% %
%      %% %% %% %% %%      %
% %% %%%% %% %% %% %%%% %% %
% %% %%%% %% %% %% %%%% %% %
% %%   %% %%    %% %%   %% %
% %%%% %% %%%%%%%% %% %%%% %
% %%%% %% %%%%%%%% %% %%%% %
%                          %
%%% %%%%% %%%  %%% %%%%% %%%
% % %%%%% %      % %%%%% % %
% %    %% %      % %%    % %
% % %% %% %      % %% %% % %
%%% %% %% %%%%%%%% %% %% %%%
%   %%                %%   %
% %%%% %%%%% %% %%%%% %%%% %
% %%%% %%%%% %% %%%%% %%%% %
%      %%    %%    %%      %
%%% %% %% %%%%%%%% %% %% %%%
%%% %% %% %%%%%%%% %% %% %%%
%   %%                %%   %
%%% %%%%%%%% %% %%%%%%%% %%%
%%% %%%%%%%% %% %%%%%%%% %%%
%            %%            %
% %%%%% %% %%%%%% %% %%%%% %
% %%%%% %% %%%%%% %% %%%%% %
%.      %%   P    %%      .%
%%%%%%%%%%%%%%%%%%%%%%%%%%%%