%%%%%%%%%%%%%%%%%%%%%%%%%%%%
%.                        .%
% %%%% %% %%%%%%%% %% %%%% %
% %  % %% %%%%%%%% %% %  % %
% %%%% %%    %%    %% %%%% %
%      %% %% %% %% %%      %
%%%% %%%% %% %% %% %%%% %%%%
%%%% %%%% %% %% %% %%%% %%%%
%      %% %%    %% %%      %
%%%%%% %% %%%%%%%% %% %%%%%%
%%%%%% %% %%%%%%%% %% %%%%%%
%      %%          %%      %
% %%%% %% %%%  %%% %% %%%% %
% %%%% %% %      % %% %%%% %
% %%      %      %      %% %
% %% %%%% %      % %%%% %% %
% %% %%%% %%%%%%%% %%%% %% %
%    %%              %%    %
%%%% %% %%%% %% %%%% %% %%%%
%%%% %% %%%% %% %%%% %% %%%%
%       %%   %%   %%       %
% %%%%% %% %%%%%% %% %%%%% %
% %%%%% %% %%%%%% %% %%%%% %
%    %%              %%    %
% %% %% %% %%%%%% %% %% %% %
% %% %% %% %%%%%% %% %% %% %
% %%    %%   %%   %%    %% %
% %%%%% %%%% %% %%%% %%%%% %
% %%%%% %%%% %% %%%% %%%%% %
%.           P            .%
%%%%%%%%%%%%%%%%%%%%%%%%%%%%