%%%%%%%%%%%%%%%%%%%%%%%%%%%%
%.           %%           .%
% %%%%% %%%% %% %%%% %%%%% %
% %%%%% %  % %% %  % %%%%% %
%    %% %%%% %% %%%% %%    %
% %% %%              %% %% %
% %% %% %% %%%%%% %% %% %% %
% %% %% %% %%%%%% %% %% %% %
% %%    %%   %%   %%    %% %
% %%%%% %%%% %% %%%% %%%%% %
% %%%%% %%%% %% %%%% %%%%% %
%                          %
%%% %%%%% %%%  %%% %%%%% %%%
%%% %%%%% %      % %%%%% %%%
%      %% %      % %%      %
% %%%% %% %      % %% %%%% %
% %%%% %% %%%%%%%% %% %%%% %
% %%                    %% %
% %% %%%%%%% %% %%%%%%% %% %
% %% %%%%%%% %% %%%%%%% %% %
%    %%      %%      %%    %
%%%% %% %% %%%%%% %% %% %%%%
%%%% %% %% %%%%%% %% %% %%%%
%       %%        %%       %
%%%% %% %%%% %% %%%% %% %%%%
%%%% %% %%%% %% %%%% %% %%%%
%    %% %%   %%   %% %%    %
% %%%%% %% %%%%%% %% %%%%% %
% %%%%% %% %%%%%% %% %%%%% %
%.           P            .%
%%%%%%%%%%%%%%%%%%%%%%%%%%%%