%%%%%%%%%%%%%%%%%%%%%%%%%%%%
%.                        .%
% %%%%%%% %%%%%%%% %%%%%%% %
% %%%%%%% %%%%%%%% %%%%%%% %
%      %%    %%    %%      %
%%% %% %% %% %% %% %% %% %%%
%%% %% %% %% %% %% %% %% %%%
%   %%    %% %% %%    %%   %
% %%%% %% %%    %% %% %%%% %
% %%%% %% %%%%%%%% %% %%%% %
%      %% %%%%%%%% %%      %
%%% %%%%%          %%%%% %%%
%%% %%%%% %%%  %%% %%%%% %%%
%         %      %         %
%%% %%%%% %      % %%%%% %%%
% % %%%%% %      % %%%%% % %
% %    %% %%%%%%%% %%    % %
% % %% %%          %% %% % %
% % %% %% %%%%%%%% %% %% % %
%%% %% %% %%%%%%%% %% %% %%%
%   %%       %%       %%   %
% %%%%%%% %% %% %% %%%%%%% %
% %%%%%%% %% %% %% %%%%%%% %
%         %%    %%         %
% %% %%%% %% %% %% %%%% %% %
% %% %%%% %% %% %% %%%% %% %
% %%   %%    %%    %%   %% %
% %%%% %% %%%%%%%% %% %%%% %
% %%%% %% %%%%%%%% %% %%%% %
%.     %%    P     %%     .%
%%%%%%%%%%%%%%%%%%%%%%%%%%%%