%%%%%%%%%%%%%%%%%%%%%%%%%%%%
%.        %%    %%        .%
% %%%%%%% %% %% %% %%%%%%% %
% %%%%%%% %% %% %% %%%%%%% %
%   %%       %%       %%   %
%%% %% %% %%%%%%%% %% %% %%%
% % %% %% %%%%%%%% %% %% % %
%%% %% %%          %% %% %%%
%      %% %%%%%%%% %%      %
%%% %%%%% %      % %%%%% %%%
%%% %%%%% %%%%%%%% %%%%% %%%
%                          %
% %%%%%%% %%%  %%% %%%%%%% %
% %%%%%%% %      % %%%%%%% %
%   %%    %      %    %%   %
%%% %% %% %      % %% %% %%%
% % %% %% %%%%%%%% %% %% % %
% %    %%          %%    % %
% % %% %% %%%%%%%% %% %% % %
%%% %% %% %%%%%%%% %% %% %%%
%   %% %%    %%    %% %%   %
% %%%% %%%%% %% %%%%% %%%% %
% %%%% %%%%% %% %%%%% %%%% %
%                          %
% %% %%%% %%%%%%%% %%%% %% %
% %% %%%% %%%%%%%% %%%% %% %
% %%   %%    %%    %%   %% %
% %%%% %% %% %% %% %% %%%% %
% %%%% %% %% %% %% %% %%%% %
%.        %% P  %%        .%
%%%%%%%%%%%%%%%%%%%%%%%%%%%%