%%%%%%%%%%%%%%%%%%%%%%%%%%%%
%.     %%          %%     .%
% %%%% %% %%%%%%%% %% %%%% %
% %%%% %% %%%%%%%% %% %%%% %
%      %%    %%    %%      %
% %% %%%% %% %% %% %%%% %% %
% %% %%%% %% %% %% %%%% %% %
% %%      %% %% %%      %% %
% %%%% %% %%    %% %% %%%% %
% %%%% %% %%%%%%%% %% %%%% %
%      %% %%%%%%%% %%      %
%%% %%%%%          %%%%% %%%
%%% %%%%% %%%  %%% %%%%% %%%
%         %      %         %
% %%%% %% %      % %% %%%% %
% %  % %% %      % %% %  % %
% %%%% %% %%%%%%%% %% %%%% %
%      %%          %%      %
%%%%%% %%%%% %% %%%%% %%%%%%
%%%%%% %%%%% %% %%%%% %%%%%%
%   %%       %%       %%   %
%%% %% %% %%%%%%%% %% %% %%%
%%% %% %% %%%%%%%% %% %% %%%
%      %%          %%      %
% %%%% %% %%%%%%%% %% %%%% %
% %%%% %% %%%%%%%% %% %%%% %
% %%   %%    %%    %%   %% %
% %% %%%%%%% %% %%%%%%% %% %
% %% %%%%%%% %% %%%%%%% %% %
%.           P            .%
%%%%%%%%%%%%%%%%%%%%%%%%%%%%