%%%%%%%%%%%%%%%%%%%%%%%%%%%%
%.                        .%
% %%%%%%% %%%%%%%% %%%%%%% %
% %%%%%%% %%%%%%%% %%%%%%% %
%      %%    %%    %%      %
%%% %% %% %% %% %% %% %% %%%
% % %% %% %% %% %% %% %% % %
%%% %% %% %% %% %% %% %% %%%
%   %%    %%    %%    %%   %
% %%%%%%% %%%%%%%% %%%%%%% %
% %%%%%%% %%%%%%%% %%%%%%% %
%   %%                %%   %
%%% %% %% %%%  %%% %% %% %%%
%%% %% %% %      % %% %% %%%
%      %% %      % %%      %
%%% %%%%% %      % %%%%% %%%
%%% %%%%% %%%%%%%% %%%%% %%%
%                          %
% %%%%%%% %%%%%%%% %%%%%%% %
% %%%%%%% %%%%%%%% %%%%%%% %
%   %%       %%       %%   %
%%% %% %%%%% %% %%%%% %% %%%
% % %% %%%%% %% %%%%% %% % %
% %                      % %
% % %% %% %%%%%%%% %% %% % %
%%% %% %% %%%%%%%% %% %% %%%
%   %% %%    %%    %% %%   %
% %%%% %%%%% %% %%%%% %%%% %
% %%%% %%%%% %% %%%%% %%%% %
%.           P            .%
%%%%%%%%%%%%%%%%%%%%%%%%%%%%