%%%%%%%%%%%%%%%%%%%%%%%%%%%%
%.                        .%
% %%%%%%% %%%%%%%% %%%%%%% %
% %%%%%%% %%%%%%%% %%%%%%% %
%   %%    %%    %%    %%   %
%%% %% %% %% %% %% %% %% %%%
%%% %% %% %% %% %% %% %% %%%
%      %% %% %% %% %%      %
% %%%% %%    %%    %% %%%% %
% %%%% %% %%%%%%%% %% %%%% %
%   %% %% %%%%%%%% %% %%   %
%%% %%                %% %%%
% % %% %% %%%  %%% %% %% % %
%%% %% %% %      % %% %% %%%
%      %% %      % %%      %
% %%%%%%% %      % %%%%%%% %
% %%%%%%% %%%%%%%% %%%%%%% %
%                          %
%%%%%% %% %%%%%%%% %% %%%%%%
%%%%%% %% %%%%%%%% %% %%%%%%
%      %%    %%    %%      %
% %% %%%% %% %% %% %%%% %% %
% %% %%%% %% %% %% %%%% %% %
% %%      %%    %%      %% %
% %%%%% %%%% %% %%%% %%%%% %
% %%%%% %%%% %% %%%% %%%%% %
% %%         %%         %% %
% %% %%%%% %%%%%% %%%%% %% %
% %% %%%%% %%%%%% %%%%% %% %
%.           P            .%
%%%%%%%%%%%%%%%%%%%%%%%%%%%%