%%%%%%%%%%%%%%%%%%%%%%%%%%%%
%.   %%              %%   .%
% %% %% %% %%%%%% %% %% %% %
% %% %% %% %%%%%% %% %% %% %
% %%    %%   %%   %%    %% %
% %%%%% %%%% %% %%%% %%%%% %
% %%%%% %%%% %% %%%% %%%%% %
% %%                    %% %
% %% %%%% %%%%%%%% %%%% %% %
% %% %%%% %      % %%%% %% %
%      %% %%%%%%%% %%      %
% %%%% %%          %% %%%% %
% %%%% %% %%%  %%% %% %%%% %
%   %%    %      %    %%   %
%%% %% %% %      % %% %% %%%
%%% %% %% %      % %% %% %%%
%      %% %%%%%%%% %%      %
% %%%% %%          %% %%%% %
% %%%% %% %%%%%%%% %% %%%% %
%   %% %% %%%%%%%% %% %%   %
%%% %% %%    %%    %% %% %%%
% % %% %%%%% %% %%%%% %% % %
%%% %% %%%%% %% %%%%% %% %%%
%                          %
% %%%% %% %%%%%%%% %% %%%% %
% %%%% %% %%%%%%%% %% %%%% %
% %%   %%    %%    %%   %% %
% %% %%%% %% %% %% %%%% %% %
% %% %%%% %% %% %% %%%% %% %
%.        %% P  %%        .%
%%%%%%%%%%%%%%%%%%%%%%%%%%%%