%%%%%%%%%%%%%%%%%%%%%%%%%%%%
%.           %%           .%
% %%%% %%%%% %% %%%%% %%%% %
% %  % %   % %% %   % %  % %
% %%%% %%%%% %% %%%%% %%%% %
%                          %
% %%%%%%%% %%%%%% %%%%%%%% %
% %%%%%%%% %%%%%% %%%%%%%% %
% %%         %%         %% %
% %% %% %%%% %% %%%% %% %% %
% %% %% %%%% %% %%%% %% %% %
%    %%              %%    %
%%%% %%%% %%%  %%% %%%% %%%%
%%%% %%%% %      % %%%% %%%%
%         %      %         %
% %%%% %% %      % %% %%%% %
% %%%% %% %%%%%%%% %% %%%% %
%   %% %%          %% %%   %
%%% %% %%%%% %% %%%%% %% %%%
%%% %% %%%%% %% %%%%% %% %%%
%            %%            %
%%% %%%%% %%%%%%%% %%%%% %%%
% % %%%%% %%%%%%%% %%%%% % %
% %    %%          %%    % %
% % %% %% %%%%%%%% %% %% % %
%%% %% %% %%%%%%%% %% %% %%%
%   %%    %%    %%    %%   %
% %%%%%%% %% %% %% %%%%%%% %
% %%%%%%% %% %% %% %%%%%%% %
%.           P            .%
%%%%%%%%%%%%%%%%%%%%%%%%%%%%