%%%%%%%%%%%%%%%%%%%%%%%%%%%%
%.     %%          %%     .%
% %%%% %% %%%%%%%% %% %%%% %
% %%%% %% %%%%%%%% %% %%%% %
%   %%    %%    %%    %%   %
%%% %% %% %% %% %% %% %% %%%
% % %% %% %% %% %% %% %% % %
%%% %% %% %% %% %% %% %% %%%
%      %%    %%    %%      %
%%% %%%%% %%%%%%%% %%%%% %%%
% % %%%%% %%%%%%%% %%%%% % %
% %    %%          %%    % %
% %%%% %% %%%  %%% %% %%%% %
%    %    %      %    %    %
%    % %% %      % %% %    %
%    % %% %      % %% %    %
% %%%% %% %%%%%%%% %% %%%% %
% %    %%          %%    % %
% % %%%%%%%% %% %%%%%%%% % %
%%% %%%%%%%% %% %%%%%%%% %%%
%      %%    %%    %%      %
%%% %% %% %%%%%%%% %% %% %%%
% % %% %% %%%%%%%% %% %% % %
% % %%                %% % %
% % %% %%%%% %% %%%%% %% % %
%%% %% %%%%% %% %%%%% %% %%%
%   %% %%    %%    %% %%   %
% %%%% %% %%%%%%%% %% %%%% %
% %%%% %% %%%%%%%% %% %%%% %
%.     %%    P     %%     .%
%%%%%%%%%%%%%%%%%%%%%%%%%%%%