%%%%%%%%%%%%%%%%%%%%%%%%%%%%
%.           %%           .%
% %%%% %%%%% %% %%%%% %%%% %
% %%%% %   % %% %   % %%%% %
%   %% %%%%% %% %%%%% %%   %
%%% %%                %% %%%
% % %% %% %%%%%%%% %% %% % %
%%% %% %% %%%%%%%% %% %% %%%
%      %%    %%    %%      %
%%% %% %%%%% %% %%%%% %% %%%
%%% %% %%%%% %% %%%%% %% %%%
%   %%                %%   %
% %%%% %% %%%  %%% %% %%%% %
% %%%% %% %      % %% %%%% %
%      %% %      % %%      %
%%% %% %% %      % %% %% %%%
%%% %% %% %%%%%%%% %% %% %%%
%   %% %%          %% %%   %
% %%%% %%%%% %% %%%%% %%%% %
% %%%% %%%%% %% %%%%% %%%% %
%            %%            %
%%%% %%%% %%%%%%%% %%%% %%%%
%%%% %%%% %%%%%%%% %%%% %%%%
%                          %
% %%%% %% %%%%%%%% %% %%%% %
% %%%% %% %%%%%%%% %% %%%% %
% %%   %% %%    %% %%   %% %
% %% %%%% %% %% %% %%%% %% %
% %% %%%% %% %% %% %%%% %% %
%.           P            .%
%%%%%%%%%%%%%%%%%%%%%%%%%%%%