%%%%%%%%%%%%%%%%%%%%%%%%%%%%
%.           %%           .%
% %%%% %%%%% %% %%%%% %%%% %
% %  % %%%%% %% %%%%% %  % %
% %%%% %%          %% %%%% %
%      %% %%%%%%%% %%      %
% %%%% %% %%%%%%%% %% %%%% %
% %%%%       %%       %%%% %
%   %% %%%%% %% %%%%% %%   %
%%% %% %   % %% %   % %% %%%
% % %% %%%%% %% %%%%% %% % %
% %                      % %
% % %% %% %%%  %%% %% %% % %
%%% %% %% %      % %% %% %%%
%   %% %% %      % %% %%   %
% %%%% %% %      % %% %%%% %
% %%%% %% %%%%%%%% %% %%%% %
%   %% %%          %% %%   %
%%% %% %%%%% %% %%%%% %% %%%
% % %% %%%%% %% %%%%% %% % %
% %          %%          % %
% % %%%%% %%%%%%%% %%%%% % %
%%% %%%%% %%%%%%%% %%%%% %%%
%      %%          %%      %
%%% %% %% %%%%%%%% %% %% %%%
%%% %% %% %%%%%%%% %% %% %%%
%   %%       %%       %%   %
% %%%%%%% %% %% %% %%%%%%% %
% %%%%%%% %% %% %% %%%%%%% %
%.        %% P  %%        .%
%%%%%%%%%%%%%%%%%%%%%%%%%%%%