%%%%%%%%%%%%%%%%%%%%%%%%%%%%
%.                        .%
% %%%% %% %%%%%%%% %% %%%% %
% %  % %% %%%%%%%% %% %  % %
% %%%% %% %%    %% %% %%%% %
%      %% %% %% %% %%      %
% %%%%%%% %% %% %% %%%%%%% %
% %%%%%%% %% %% %% %%%%%%% %
%      %%    %%    %%      %
% %%%% %% %%%%%%%% %% %%%% %
% %%%% %% %%%%%%%% %% %%%% %
%   %%                %%   %
%%% %% %% %%%  %%% %% %% %%%
%%% %% %% %      % %% %% %%%
%      %% %      % %%      %
%%% %%%%% %      % %%%%% %%%
%%% %%%%% %%%%%%%% %%%%% %%%
%                          %
% %%%%% %%%% %% %%%% %%%%% %
% %%%%% %%%% %% %%%% %%%%% %
%    %% %%   %%   %% %%    %
%%%% %% %% %%%%%% %% %% %%%%
%%%% %% %% %%%%%% %% %% %%%%
%                          %
% %%%%% %% %%%%%% %% %%%%% %
% %%%%% %% %%%%%% %% %%%%% %
% %%    %%   %%   %%    %% %
% %% %% %%%% %% %%%% %% %% %
% %% %% %%%% %% %%%% %% %% %
%.   %%      P       %%   .%
%%%%%%%%%%%%%%%%%%%%%%%%%%%%