%%%%%%%%%%%%%%%%%%%%%%%%%%%%
%.                        .%
% %%%%%%% %%%%%%%% %%%%%%% %
% %%%%%%% %%%%%%%% %%%%%%% %
%   %%       %%       %%   %
%%% %% %% %% %% %% %% %% %%%
% % %% %% %% %% %% %% %% % %
% %    %% %% %% %% %%    % %
% % %%%%% %%    %% %%%%% % %
%%% %%%%% %%%%%%%% %%%%% %%%
%      %% %%%%%%%% %%      %
%%% %% %%          %% %% %%%
% % %% %% %%%  %%% %% %% % %
%%% %% %% %      % %% %% %%%
%   %%    %      %    %%   %
% %%%%%%% %      % %%%%%%% %
% %%%%%%% %%%%%%%% %%%%%%% %
%                          %
% %%%%%%%%%% %% %%%%%%%%%% %
% %%%%%%%%%% %% %%%%%%%%%% %
%      %%    %%    %%      %
% %%%% %% %%%%%%%% %% %%%% %
% %%%% %% %%%%%%%% %% %%%% %
%                          %
% %%%% %% %%%%%%%% %% %%%% %
% %%%% %% %%%%%%%% %% %%%% %
% %%   %%    %%    %%   %% %
% %% %%%%%%% %% %%%%%%% %% %
% %% %%%%%%% %% %%%%%%% %% %
%.           P            .%
%%%%%%%%%%%%%%%%%%%%%%%%%%%%