%%%%%%%%%%%%%%%%%%%%%%%%%%%%
%.                        .%
% %%%% %% %%%%%%%% %% %%%% %
% %  % %% %      % %% %  % %
% %%%% %% %%%%%%%% %% %%%% %
%      %%          %%      %
% %%%%%%%%%% %% %%%%%%%%%% %
% %%%%%%%%%% %% %%%%%%%%%% %
%            %%            %
%%% %%%%% %%%%%%%% %%%%% %%%
% % %%%%% %%%%%%%% %%%%% % %
% % %%                %% % %
% % %% %% %%%  %%% %% %% % %
%%% %% %% %      % %% %% %%%
%      %% %      % %%      %
%%% %%%%% %      % %%%%% %%%
% % %%%%% %%%%%%%% %%%%% % %
% %                      % %
% % %% %% %%%%%%%% %% %% % %
%%% %% %% %%%%%%%% %% %% %%%
%   %% %%    %%    %% %%   %
% %%%% %%%%% %% %%%%% %%%% %
% %%%% %%%%% %% %%%%% %%%% %
%      %%          %%      %
%%% %% %% %%%%%%%% %% %% %%%
%%% %% %% %%%%%%%% %% %% %%%
%   %%    %%    %%    %%   %
% %%%%%%% %% %% %% %%%%%%% %
% %%%%%%% %% %% %% %%%%%%% %
%.           P            .%
%%%%%%%%%%%%%%%%%%%%%%%%%%%%