%%%%%%%%%%%%%%%%%%%%%%%%%%%%
%.                        .%
% %%%% %%%%% %% %%%%% %%%% %
% %%%% %%%%% %% %%%%% %%%% %
%   %% %%    %%    %% %%   %
%%% %% %% %%%%%%%% %% %% %%%
% % %% %% %%%%%%%% %% %% % %
%%% %% %%          %% %% %%%
%      %% %%%%%%%% %%      %
% %%%% %% %      % %% %%%% %
% %%%% %% %%%%%%%% %% %%%% %
% %%                    %% %
% %% %%%% %%%  %%% %%%% %% %
% %% %%%% %      % %%%% %% %
%      %% %      % %%      %
% %%%% %% %      % %% %%%% %
% %%%% %% %%%%%%%% %% %%%% %
%   %%                %%   %
%%% %% %% %%%%%%%% %% %% %%%
%%% %% %% %%%%%%%% %% %% %%%
%      %%    %%    %%      %
%%% %%%%% %% %% %% %%%%% %%%
% % %%%%% %% %% %% %%%%% % %
% %       %%    %%       % %
% % %% %%%%% %% %%%%% %% % %
%%% %% %%%%% %% %%%%% %% %%%
%   %%       %%       %%   %
% %%%% %% %%%%%%%% %% %%%% %
% %%%% %% %%%%%%%% %% %%%% %
%.     %%    P     %%     .%
%%%%%%%%%%%%%%%%%%%%%%%%%%%%