%%%%%%%%%%%%%%%%%%%%%%%%%%%%
%.     %%          %%     .%
% %%%% %% %%%%%%%% %% %%%% %
% %%%% %% %      % %% %%%% %
%   %% %% %%%%%%%% %% %%   %
%%% %%                %% %%%
%%% %% %% %%%%%%%% %% %% %%%
%      %% %%%%%%%% %%      %
% %%%% %%    %%    %% %%%% %
% %%%% %%%%% %% %%%%% %%%% %
%   %% %%%%% %% %%%%% %%   %
%%% %%                %% %%%
% % %% %% %%%  %%% %% %% % %
% % %% %% %      % %% %% % %
% %    %% %      % %%    % %
% % %% %% %      % %% %% % %
%%% %% %% %%%%%%%% %% %% %%%
%   %% %%          %% %%   %
% %%%% %%%%% %% %%%%% %%%% %
% %%%% %%%%% %% %%%%% %%%% %
%            %%            %
%%%% %%%% %%%%%%%% %%%% %%%%
%%%% %%%% %%%%%%%% %%%% %%%%
%                          %
% %%%% %% %%%%%%%% %% %%%% %
% %%%% %% %%%%%%%% %% %%%% %
% %%   %%    %%    %%   %% %
% %% %%%%%%% %% %%%%%%% %% %
% %% %%%%%%% %% %%%%%%% %% %
%.           P            .%
%%%%%%%%%%%%%%%%%%%%%%%%%%%%