%%%%%%%%%%%%%%%%%%%%%%%%%%%%
%.     %%          %%     .%
% %%%% %% %%%%%%%% %% %%%% %
% %%%% %% %%%%%%%% %% %%%% %
%   %%    %%    %%    %%   %
%%% %% %% %% %% %% %% %% %%%
% % %% %% %% %% %% %% %% % %
%%% %% %% %% %% %% %% %% %%%
%      %%    %%    %%      %
%%% %%%%% %%%%%%%% %%%%% %%%
% % %%%%% %%%%%%%% %%%%% % %
% %                      % %
% % %% %% %%%  %%% %% %% % %
%%% %% %% %      % %% %% %%%
%   %% %% %      % %% %%   %
% %%%% %% %      % %% %%%% %
% %%%% %% %%%%%%%% %% %%%% %
%      %%          %%      %
%%% %%%%%%%% %% %%%%%%%% %%%
%%% %%%%%%%% %% %%%%%%%% %%%
%            %%            %
% %%%%%%%% %%%%%% %%%%%%%% %
% %%%%%%%% %%%%%% %%%%%%%% %
%    %%              %%    %
% %% %% %% %%%%%% %% %% %% %
% %% %% %% %%%%%% %% %% %% %
% %%    %%   %%   %%    %% %
% %%%%% %%%% %% %%%% %%%%% %
% %%%%% %%%% %% %%%% %%%%% %
%.           P            .%
%%%%%%%%%%%%%%%%%%%%%%%%%%%%