%%%%%%%%%%%%%%%%%%%%%%%%%%%%
%.           %%           .%
% %%%% %%%%% %% %%%%% %%%% %
% %  % %%%%% %% %%%%% %  % %
% %  % %%          %% %  % %
% %  % %% %%%%%%%% %% %  % %
% %%%% %% %%%%%%%% %% %%%% %
%            %%            %
%%% %% %%%%% %% %%%%% %% %%%
% % %% %   % %% %   % %% % %
%%% %% %%%%% %% %%%%% %% %%%
%   %%                %%   %
% %%%%%%% %%%  %%% %%%%%%% %
% %%%%%%% %      % %%%%%%% %
%         %      %         %
% %% %%%% %      % %%%% %% %
% %% %%%% %%%%%%%% %%%% %% %
% %%                    %% %
% %%%%% %%%% %% %%%% %%%%% %
% %%%%% %%%% %% %%%% %%%%% %
% %%    %%   %%   %%    %% %
% %% %% %% %%%%%% %% %% %% %
% %% %% %% %%%%%% %% %% %% %
%    %%              %%    %
%%%% %%%%%%% %% %%%%%%% %%%%
%%%% %%%%%%% %% %%%%%%% %%%%
%            %%            %
% %%%% %% %%%%%%%% %% %%%% %
% %%%% %% %%%%%%%% %% %%%% %
%.     %%    P     %%     .%
%%%%%%%%%%%%%%%%%%%%%%%%%%%%