%%%%%%%%%%%%%%%%%%%%%%%%%%%%
%.           %%           .%
% %% %%%%%%% %% %%%%%%% %% %
% %% %%%%%%% %% %%%%%%% %% %
% %%      %% %% %%      %% %
% %%%% %% %%    %% %% %%%% %
% %%%% %% %% %% %% %% %%%% %
%      %% %% %% %% %%      %
% %% %%%%    %%    %%%% %% %
% %% %%%% %%%%%%%% %%%% %% %
% %%   %% %%%%%%%% %%   %% %
% %%%% %%          %% %%%% %
% %%%% %% %%%  %%% %% %%%% %
% %%      %      %      %% %
% %% %%%% %      % %%%% %% %
% %% %  % %      % %  % %% %
% %% %%%% %%%%%%%% %%%% %% %
%                          %
% %%%% %% %%%%%%%% %% %%%% %
% %%%% %% %%%%%%%% %% %%%% %
% %%   %%    %%    %%   %% %
% %% %%%%%%% %% %%%%%%% %% %
% %% %%%%%%% %% %%%%%%% %% %
%                          %
% %% %%%% %%%%%%%% %%%% %% %
% %% %%%% %%%%%%%% %%%% %% %
% %%   %% %%    %% %%   %% %
% %%%% %% %% %% %% %% %%%% %
% %%%% %% %% %% %% %% %%%% %
%.     %%    P     %%     .%
%%%%%%%%%%%%%%%%%%%%%%%%%%%%