%%%%%%%%%%%%%%%%%%%%%%%%%%%%
%.        %%    %%        .%
% %%%% %% %% %% %% %% %%%% %
% %%%% %% %% %% %% %% %%%% %
% %%   %% %% %% %% %%   %% %
% %% %%%%    %%    %%%% %% %
% %% %%%% %%%%%%%% %%%% %% %
%      %% %%%%%%%% %%      %
% %%%% %%          %% %%%% %
% %  % %% %%%%%%%% %% %  % %
% %%%% %% %%%%%%%% %% %%%% %
%                          %
% %%%%%%% %%%  %%% %%%%%%% %
% %%%%%%% %      % %%%%%%% %
%      %% %      % %%      %
% %%%% %% %      % %% %%%% %
% %%%% %% %%%%%%%% %% %%%% %
%   %%                %%   %
%%% %% %% %%%%%%%% %% %% %%%
%%% %% %% %%%%%%%% %% %% %%%
%      %%          %%      %
%%% %%%%% %%%%%%%% %%%%% %%%
% % %%%%% %%%%%%%% %%%%% % %
% %    %% %%    %% %%    % %
% % %% %% %% %% %% %% %% % %
%%% %% %% %% %% %% %% %% %%%
%   %%       %%       %%   %
% %%%%%%% %%%%%%%% %%%%%%% %
% %%%%%%% %%%%%%%% %%%%%%% %
%.           P            .%
%%%%%%%%%%%%%%%%%%%%%%%%%%%%