%%%%%%%%%%%%%%%%%%%%%%%%%%%%
%.                        .%
% %%%% %% %%%%%%%% %% %%%% %
% %  % %% %      % %% %  % %
% %%%% %% %%%%%%%% %% %%%% %
%      %%          %%      %
% %%%% %%%%% %% %%%%% %%%% %
% %%%% %%%%% %% %%%%% %%%% %
%   %%       %%       %%   %
%%% %% %% %%%%%%%% %% %% %%%
% % %% %% %%%%%%%% %% %% % %
% %    %%          %%    % %
% % %%%%% %%%  %%% %%%%% % %
%%% %%%%% %      % %%%%% %%%
%         %      %         %
% %%%% %% %      % %% %%%% %
% %%%% %% %%%%%%%% %% %%%% %
%   %% %%          %% %%   %
%%% %% %%%%% %% %%%%% %% %%%
% % %% %%%%% %% %%%%% %% % %
% %          %%          % %
% % %% %% %%%%%%%% %% %% % %
%%% %% %% %%%%%%%% %% %% %%%
%   %% %%          %% %%   %
%%% %% %%%%% %% %%%%% %% %%%
%%% %% %%%%% %% %%%%% %% %%%
%   %%       %%       %%   %
% %%%%%%%% %%%%%% %%%%%%%% %
% %%%%%%%% %%%%%% %%%%%%%% %
%.           P            .%
%%%%%%%%%%%%%%%%%%%%%%%%%%%%