%%%%%%%%%%%%%%%%%%%%%%%%%%%%
%.                        .%
% %%%% %% %%%%%%%% %% %%%% %
% %%%% %% %%%%%%%% %% %%%% %
% %%   %%    %%    %%   %% %
% %% %%%% %% %% %% %%%% %% %
% %% %%%% %% %% %% %%%% %% %
%         %% %% %%         %
%%%% %%%% %%    %% %%%% %%%%
%%%% %%%% %%%%%%%% %%%% %%%%
%      %% %%%%%%%% %%      %
% %%%% %%          %% %%%% %
% %%%% %% %%%  %%% %% %%%% %
%   %%    %      %    %%   %
%%% %% %% %      % %% %% %%%
% % %% %% %      % %% %% % %
%%% %% %% %%%%%%%% %% %% %%%
%      %%          %%      %
% %%%% %% %%%%%%%% %% %%%% %
% %%%% %% %%%%%%%% %% %%%% %
% %%         %%         %% %
% %% %%%%%%% %% %%%%%%% %% %
% %% %%%%%%% %% %%%%%%% %% %
%         %%    %%         %
% %%%% %% %% %% %% %% %%%% %
% %%%% %% %% %% %% %% %%%% %
% %%   %%    %%    %%   %% %
% %% %%%% %%%%%%%% %%%% %% %
% %% %%%% %%%%%%%% %%%% %% %
%.           P            .%
%%%%%%%%%%%%%%%%%%%%%%%%%%%%