%%%%%%%%%%%%%%%%%%%%%%%%%%%%
%.                        .%
% %% %%%% %%%%%%%% %%%% %% %
% %% %%%% %%%%%%%% %%%% %% %
% %%         %%         %% %
% %%%% %% %% %% %% %% %%%% %
% %%%% %% %% %% %% %% %%%% %
% %%   %% %% %% %% %%   %% %
% %% %%%% %%    %% %%%% %% %
% %% %%%% %%%%%%%% %%%% %% %
%      %% %%%%%%%% %%      %
% %%%% %%          %% %%%% %
% %%%% %% %%%  %%% %% %%%% %
%   %% %% %      % %% %%   %
%%% %%    %      %    %% %%%
% % %% %% %      % %% %% % %
% % %% %% %%%%%%%% %% %% % %
% %    %%          %%    % %
% % %% %%%%% %% %%%%% %% % %
%%% %% %%%%% %% %%%%% %% %%%
%   %% %%    %%    %% %%   %
% %%%% %% %%%%%%%% %% %%%% %
% %%%% %% %%%%%%%% %% %%%% %
%      %%          %%      %
%%% %% %% %%%%%%%% %% %% %%%
%%% %% %% %%%%%%%% %% %% %%%
%   %%    %%    %%    %%   %
% %%%%%%% %% %% %% %%%%%%% %
% %%%%%%% %% %% %% %%%%%%% %
%.           P            .%
%%%%%%%%%%%%%%%%%%%%%%%%%%%%