%%%%%%%%%%%%%%%%%%%%%%%%%%%%
%.                        .%
% %%%% %% %%%%%%%% %% %%%% %
% %%%% %% %      % %% %%%% %
%   %% %% %%%%%%%% %% %%   %
%%% %% %%          %% %% %%%
%%% %% %%%%% %% %%%%% %% %%%
%      %%%%% %% %%%%%      %
% %%%% %%    %%    %% %%%% %
% %%%% %% %%%%%%%% %% %%%% %
%   %% %% %%%%%%%% %% %%   %
%%% %%                %% %%%
% % %% %% %%%  %%% %% %% % %
% % %% %% %      % %% %% % %
% %    %% %      % %%    % %
% % %% %% %      % %% %% % %
%%% %% %% %%%%%%%% %% %% %%%
%   %%                %%   %
% %%%% %% %%%%%%%% %% %%%% %
% %%%% %% %%%%%%%% %% %%%% %
%      %%    %%    %%      %
%%% %% %%%%% %% %%%%% %% %%%
%%% %% %%%%% %% %%%%% %% %%%
%   %% %%          %% %%   %
%%% %% %% %%%%%%%% %% %% %%%
%%% %% %% %%%%%%%% %% %% %%%
%   %%       %%       %%   %
% %%%%%%% %% %% %% %%%%%%% %
% %%%%%%% %% %% %% %%%%%%% %
%.        %% P  %%        .%
%%%%%%%%%%%%%%%%%%%%%%%%%%%%