%%%%%%%%%%%%%%%%%%%%%%%%%%%%
%.           %%           .%
% %% %%%% %% %% %% %%%% %% %
% %% %%%% %% %% %% %%%% %% %
% %%   %% %%    %% %%   %% %
% %%%% %% %%%%%%%% %% %%%% %
% %%%% %% %%%%%%%% %% %%%% %
% %%                    %% %
% %% %%%% %%%%%%%% %%%% %% %
% %% %%%% %      % %%%% %% %
%      %% %%%%%%%% %%      %
% %%%% %%          %% %%%% %
% %%%% %% %%%  %%% %% %%%% %
%   %%    %      %    %%   %
%%% %% %% %      % %% %% %%%
% % %% %% %      % %% %% % %
%%% %% %% %%%%%%%% %% %% %%%
%      %%          %%      %
%%% %%%%% %%%%%%%% %%%%% %%%
%%% %%%%% %%%%%%%% %%%%% %%%
%            %%            %
% %%%%% %%%% %% %%%% %%%%% %
% %%%%% %%%% %% %%%% %%%%% %
%    %%              %%    %
%%%% %% %% %%%%%% %% %% %%%%
%%%% %% %% %%%%%% %% %% %%%%
%       %%   %%   %%       %
% %%%%%%%%%% %% %%%%%%%%%% %
% %%%%%%%%%% %% %%%%%%%%%% %
%.           P            .%
%%%%%%%%%%%%%%%%%%%%%%%%%%%%