%%%%%%%%%%%%%%%%%%%%%%%%%%%%
%.     %%          %%     .%
% %%%% %% %%%%%%%% %% %%%% %
% %%%% %% %%%%%%%% %% %%%% %
%   %%    %%    %%    %%   %
%%% %% %% %% %% %% %% %% %%%
% % %% %% %% %% %% %% %% % %
% % %% %% %% %% %% %% %% % %
% %    %%    %%    %%    % %
% % %%%%% %%%%%%%% %%%%% % %
%%% %%%%% %%%%%%%% %%%%% %%%
%      %%          %%      %
% %%%% %% %%%  %%% %% %%%% %
% %%%% %% %      % %% %%%% %
%         %      %         %
% %%%%%%% %      % %%%%%%% %
% %%%%%%% %%%%%%%% %%%%%%% %
%    %%              %%    %
%%%% %% %%%% %% %%%% %% %%%%
%%%% %% %%%% %% %%%% %% %%%%
%         %% %% %%         %
%%%% %%%% %% %% %% %%%% %%%%
%%%% %%%% %% %% %% %%%% %%%%
%         %%    %%         %
% %% %%%% %% %% %% %%%% %% %
% %% %%%% %% %% %% %%%% %% %
% %%   %%    %%    %%   %% %
% %%%% %% %%%%%%%% %% %%%% %
% %%%% %% %%%%%%%% %% %%%% %
%.           P            .%
%%%%%%%%%%%%%%%%%%%%%%%%%%%%