%%%%%%%%%%%%%%%%%%%%%%%%%%%%
%.           %%           .%
% %%%% %%%%% %% %%%%% %%%% %
% %%%% %%%%% %% %%%%% %%%% %
%   %%    %% %% %%    %%   %
%%% %% %% %%    %% %% %% %%%
% % %% %% %% %% %% %% %% % %
%%% %% %% %% %% %% %% %% %%%
%      %%    %%    %%      %
%%% %%%%% %%%%%%%% %%%%% %%%
% % %%%%% %%%%%%%% %%%%% % %
% %                      % %
% % %%%%% %%%  %%% %%%%% % %
% % %%%%% %      % %%%%% % %
% % %%    %      %    %% % %
% % %% %% %      % %% %% % %
%%% %% %% %%%%%%%% %% %% %%%
%      %%          %%      %
% %%%%%%% %%%%%%%% %%%%%%% %
% %%%%%%% %%%%%%%% %%%%%%% %
%            %%            %
% %%%%% %%%% %% %%%% %%%%% %
% %%%%% %  % %% %  % %%%%% %
% %%    %  %    %  %    %% %
% %% %% %  % %% %  % %% %% %
% %% %% %%%% %% %%%% %% %% %
%    %%      %%      %%    %
% %%%%%%%% %%%%%% %%%%%%%% %
% %%%%%%%% %%%%%% %%%%%%%% %
%.           P            .%
%%%%%%%%%%%%%%%%%%%%%%%%%%%%