%%%%%%%%%%%%%%%%%%%%%%%%%%%%
%.     %%          %%     .%
% %%%% %% %%%%%%%% %% %%%% %
% %  % %% %%%%%%%% %% %  % %
% %  % %% %%    %% %% %  % %
% %  %    %% %% %%    %  % %
% %%%% %% %% %% %% %% %%%% %
%      %% %% %% %% %%      %
%%% %% %%    %%    %% %% %%%
% % %% %%%%% %% %%%%% %% % %
%%% %% %%%%% %% %%%%% %% %%%
%   %%                %%   %
% %%%% %% %%%  %%% %% %%%% %
% %%%% %% %      % %% %%%% %
%      %% %      % %%      %
%%%% %%%% %      % %%%% %%%%
%%%% %%%% %%%%%%%% %%%% %%%%
%      %%          %%      %
% %%%% %% %%%%%%%% %% %%%% %
% %%%% %% %%%%%%%% %% %%%% %
%            %%            %
%%%% %%%%%%% %% %%%%%%% %%%%
%%%% %%%%%%% %% %%%%%%% %%%%
%         %%    %%         %
% %% %%%% %% %% %% %%%% %% %
% %% %%%% %% %% %% %%%% %% %
% %%   %%    %%    %%   %% %
% %%%% %% %%%%%%%% %% %%%% %
% %%%% %% %%%%%%%% %% %%%% %
%.     %%    P     %%     .%
%%%%%%%%%%%%%%%%%%%%%%%%%%%%