%%%%%%%%%%%%%%%%%%%%%%%%%%%%
%.                        .%
% %%%% %% %%%%%%%% %% %%%% %
% %  % %% %%%%%%%% %% %  % %
% %%%% %% %%    %% %% %%%% %
%      %% %% %% %% %%      %
% %% %%%% %% %% %% %%%% %% %
% %% %%%% %% %% %% %%%% %% %
% %%   %%    %%    %%   %% %
% %%%% %% %%%%%%%% %% %%%% %
% %%%% %% %%%%%%%% %% %%%% %
%                          %
%%% %%%%% %%%  %%% %%%%% %%%
%%% %%%%% %      % %%%%% %%%
%      %% %      % %%      %
% %%%% %% %      % %% %%%% %
% %%%% %% %%%%%%%% %% %%%% %
% %%                    %% %
% %% %%%%%%% %% %%%%%%% %% %
% %% %%%%%%% %% %%%%%%% %% %
%    %%      %%      %%    %
%%%% %% %% %%%%%% %% %% %%%%
%%%% %% %% %%%%%% %% %% %%%%
%       %%        %%       %
%%%% %% %%%% %% %%%% %% %%%%
%%%% %% %%%% %% %%%% %% %%%%
%    %%      %%      %%    %
% %%%%%%%% %%%%%% %%%%%%%% %
% %%%%%%%% %%%%%% %%%%%%%% %
%.           P            .%
%%%%%%%%%%%%%%%%%%%%%%%%%%%%