%%%%%%%%%%%%%%%%%%%%%%%%%%%%
%.           %%           .%
% %%%% %%%%% %% %%%%% %%%% %
% %  % %   % %% %   % %  % %
% %%%% %%%%% %% %%%%% %%%% %
%                          %
%%% %%%%%%%% %% %%%%%%%% %%%
%%% %%%%%%%% %% %%%%%%%% %%%
%         %% %% %%         %
% %%%% %% %% %% %% %% %%%% %
% %%%% %% %% %% %% %% %%%% %
% %%   %%          %%   %% %
% %% %%%% %%%  %%% %%%% %% %
% %% %%%% %      % %%%% %% %
%         %      %         %
% %%%% %% %      % %% %%%% %
% %%%% %% %%%%%%%% %% %%%% %
%      %%          %%      %
%%%% %%%% %%%%%%%% %%%% %%%%
%%%% %%%% %%%%%%%% %%%% %%%%
%            %%            %
% %%%% %%%%% %% %%%%% %%%% %
% %%%% %%%%% %% %%%%% %%%% %
% %%      %%    %%      %% %
% %% %%%% %% %% %% %%%% %% %
% %% %%%% %% %% %% %%%% %% %
%      %%    %%    %%      %
% %%%% %% %%%%%%%% %% %%%% %
% %%%% %% %%%%%%%% %% %%%% %
%.           P            .%
%%%%%%%%%%%%%%%%%%%%%%%%%%%%