%%%%%%%%%%%%%%%%%%%%%%%%%%%%
%.                        .%
% %%%% %% %%%%%%%% %% %%%% %
% %%%% %% %      % %% %%%% %
%   %% %% %%%%%%%% %% %%   %
%%% %% %%          %% %% %%%
% % %% %% %%%%%%%% %% %% % %
%%% %% %% %%%%%%%% %% %% %%%
%      %%    %%    %%      %
%%% %%%%%%%% %% %%%%%%%% %%%
%%% %%%%%%%% %% %%%%%%%% %%%
%                          %
% %%%%%%% %%%  %%% %%%%%%% %
% %%%%%%% %      % %%%%%%% %
%   %%    %      %    %%   %
%%% %% %% %      % %% %% %%%
% % %% %% %%%%%%%% %% %% % %
% %    %%          %%    % %
% % %%%%% %%%%%%%% %%%%% % %
%%% %%%%% %%%%%%%% %%%%% %%%
%            %%            %
% %%%%% %%%% %% %%%% %%%%% %
% %%%%% %%%% %% %%%% %%%%% %
%    %%              %%    %
% %% %% %%%% %% %%%% %% %% %
% %% %% %%%% %% %%%% %% %% %
% %%    %%   %%   %%    %% %
% %%%%% %% %%%%%% %% %%%%% %
% %%%%% %% %%%%%% %% %%%%% %
%.           P            .%
%%%%%%%%%%%%%%%%%%%%%%%%%%%%