%%%%%%%%%%%%%%%%%%%%%%%%%%%%
%.     %%          %%     .%
% %%%% %% %%%%%%%% %% %%%% %
% %%%% %% %      % %% %%%% %
%   %% %% %%%%%%%% %% %%   %
%%% %%                %% %%%
%%% %% %% %%%%%%%% %% %% %%%
%      %% %%%%%%%% %%      %
%%% %% %%    %%    %% %% %%%
% % %% %%%%% %% %%%%% %% % %
%%% %% %%%%% %% %%%%% %% %%%
%   %%                %%   %
% %%%% %% %%%  %%% %% %%%% %
% %%%% %% %      % %% %%%% %
%      %% %      % %%      %
% %% %%%% %      % %%%% %% %
% %% %%%% %%%%%%%% %%%% %% %
% %%                    %% %
% %%%% %% %%%%%%%% %% %%%% %
% %%%% %% %%%%%%%% %% %%%% %
%      %%    %%    %%      %
% %% %%%%%%% %% %%%%%%% %% %
% %% %%%%%%% %% %%%%%%% %% %
% %%                    %% %
% %%%% %% %%%%%%%% %% %%%% %
% %%%% %% %%%%%%%% %% %%%% %
%      %%    %%    %%      %
% %%%%%%%%%% %% %%%%%%%%%% %
% %%%%%%%%%% %% %%%%%%%%%% %
%.           P            .%
%%%%%%%%%%%%%%%%%%%%%%%%%%%%