%%%%%%%%%%%%%%%%%%%%%%%%%%%%
%.        %%    %%        .%
% %%%% %% %% %% %% %% %%%% %
% %  % %% %% %% %% %% %  % %
% %%%% %% %% %% %% %% %%%% %
%      %%    %%    %%      %
% %% %%%% %% %% %% %%%% %% %
% %% %%%% %% %% %% %%%% %% %
% %%      %%    %%      %% %
% %%%% %% %%%%%%%% %% %%%% %
% %%%% %% %%%%%%%% %% %%%% %
%      %%          %%      %
% %% %%%% %%%  %%% %%%% %% %
% %% %%%% %      % %%%% %% %
% %%      %      %      %% %
% %%%%%%% %      % %%%%%%% %
% %%%%%%% %%%%%%%% %%%%%%% %
%                          %
%%%% %% %%%% %% %%%% %% %%%%
%%%% %% %%%% %% %%%% %% %%%%
%    %%      %%      %%    %
%%%% %%%% %%%%%%%% %%%% %%%%
%%%% %%%% %%%%%%%% %%%% %%%%
%                          %
% %% %%%% %%%%%%%% %%%% %% %
% %% %%%% %%%%%%%% %%%% %% %
% %%   %%    %%    %%   %% %
% %%%% %% %% %% %% %% %%%% %
% %%%% %% %% %% %% %% %%%% %
%.        %% P  %%        .%
%%%%%%%%%%%%%%%%%%%%%%%%%%%%