%%%%%%%%%%%%%%%%%%%%%%%%%%%%
%.                        .%
% %%%%% %% %%%%%% %% %%%%% %
% %%%%% %% %    % %% %%%%% %
% %%    %% %%%%%% %%    %% %
% %% %% %%        %% %% %% %
% %% %% %% %%%%%% %% %% %% %
% %% %% %% %%%%%% %% %% %% %
%    %% %%   %%   %% %%    %
% %%%%% %%%% %% %%%% %%%%% %
% %%%%% %%%% %% %%%% %%%%% %
%                          %
%%%% %%%% %%%  %%% %%%% %%%%
%%%% %%%% %      % %%%% %%%%
%      %% %      % %%      %
% %%%% %% %      % %% %%%% %
% %%%% %% %%%%%%%% %% %%%% %
%   %%                %%   %
%%% %% %% %%%%%%%% %% %% %%%
%%% %% %% %%%%%%%% %% %% %%%
%      %%    %%    %%      %
%%% %%%%%%%% %% %%%%%%%% %%%
% % %%%%%%%% %% %%%%%%%% % %
% %                      % %
% % %% %% %%%%%%%% %% %% % %
%%% %% %% %%%%%%%% %% %% %%%
%   %% %%    %%    %% %%   %
% %%%% %%%%% %% %%%%% %%%% %
% %%%% %%%%% %% %%%%% %%%% %
%.           P            .%
%%%%%%%%%%%%%%%%%%%%%%%%%%%%