%%%%%%%%%%%%%%%%%%%%%%%%%%%%
%.           %%           .%
% %%%% %%%%% %% %%%%% %%%% %
% %%%% %   % %% %   % %%%% %
%   %% %%%%% %% %%%%% %%   %
%%% %%                %% %%%
% % %% %% %%%%%%%% %% %% % %
%%% %% %% %%%%%%%% %% %% %%%
%      %%    %%    %%      %
%%% %% %%%%% %% %%%%% %% %%%
% % %% %%%%% %% %%%%% %% % %
% % %%                %% % %
% % %%%%% %%%  %%% %%%%% % %
%%% %%%%% %      % %%%%% %%%
%         %      %         %
% %%%% %% %      % %% %%%% %
% %%%% %% %%%%%%%% %% %%%% %
%   %% %%          %% %%   %
%%% %% %%%%% %% %%%%% %% %%%
%%% %% %%%%% %% %%%%% %% %%%
%            %%            %
%%% %% %% %%%%%%%% %% %% %%%
%%% %% %% %%%%%%%% %% %% %%%
%   %% %%          %% %%   %
% %%%% %% %%%%%%%% %% %%%% %
% %%%% %% %%%%%%%% %% %%%% %
%      %%    %%    %%      %
% %%%% %%%%% %% %%%%% %%%% %
% %%%% %%%%% %% %%%%% %%%% %
%.           P            .%
%%%%%%%%%%%%%%%%%%%%%%%%%%%%