%%%%%%%%%%%%%%%%%%%%%%%%%%%%
%.           %%           .%
% %%%% %%%%% %% %%%%% %%%% %
% %%%% %   % %% %   % %%%% %
%   %% %%%%% %% %%%%% %%   %
%%% %%                %% %%%
% % %% %% %%%%%%%% %% %% % %
% % %% %% %%%%%%%% %% %% % %
% %    %%    %%    %%    % %
% % %% %%%%% %% %%%%% %% % %
%%% %% %%%%% %% %%%%% %% %%%
%   %% %%          %% %%   %
%%%%%% %% %%%  %%% %% %%%%%%
%%%%%% %% %      % %% %%%%%%
%   %% %% %      % %% %%   %
%%% %% %% %      % %% %% %%%
% % %% %% %%%%%%%% %% %% % %
% %                      % %
% % %% %%%%% %% %%%%% %% % %
%%% %% %%%%% %% %%%%% %% %%%
%   %%       %%       %%   %
% %%%%%%% %%%%%%%% %%%%%%% %
% %%%%%%% %%%%%%%% %%%%%%% %
%                          %
% %% %%%%%%% %% %%%%%%% %% %
% %% %%%%%%% %% %%%%%%% %% %
% %%    %%   %%   %%    %% %
% %%%%% %% %%%%%% %% %%%%% %
% %%%%% %% %%%%%% %% %%%%% %
%.           P            .%
%%%%%%%%%%%%%%%%%%%%%%%%%%%%