%%%%%%%%%%%%%%%%%%%%%%%%%%%%
%.                        .%
% %%%%%%% %%%%%%%% %%%%%%% %
% %%%%%%% %%%%%%%% %%%%%%% %
%   %%    %%    %%    %%   %
%%% %% %% %% %% %% %% %% %%%
% % %% %% %% %% %% %% %% % %
%%% %% %% %% %% %% %% %% %%%
%      %%    %%    %%      %
%%% %% %%%%% %% %%%%% %% %%%
%%% %% %%%%% %% %%%%% %% %%%
%   %%                %%   %
% %%%% %% %%%  %%% %% %%%% %
% %%%% %% %      % %% %%%% %
%      %% %      % %%      %
%%%% %%%% %      % %%%% %%%%
%%%% %%%% %%%%%%%% %%%% %%%%
%                          %
% %%%% %%%%% %% %%%%% %%%% %
% %%%% %%%%% %% %%%%% %%%% %
%      %%    %%    %%      %
%%% %% %% %%%%%%%% %% %% %%%
%%% %% %% %%%%%%%% %% %% %%%
%   %%                %%   %
%%%%%% %% %%%%%%%% %% %%%%%%
%%%%%% %% %%%%%%%% %% %%%%%%
%      %%    %%    %%      %
% %%%%%%%%%% %% %%%%%%%%%% %
% %%%%%%%%%% %% %%%%%%%%%% %
%.           P            .%
%%%%%%%%%%%%%%%%%%%%%%%%%%%%