%%%%%%%%%%%%%%%%%%%%%%%%%%%%
%.                        .%
% %%%% %% %%%%%%%% %% %%%% %
% %%%% %% %      % %% %%%% %
%   %% %% %%%%%%%% %% %%   %
%%% %% %%          %% %% %%%
%%% %% %% %%%%%%%% %% %% %%%
%      %% %%%%%%%% %%      %
%%% %% %%    %%    %% %% %%%
% % %% %%%%% %% %%%%% %% % %
% % %% %%%%% %% %%%%% %% % %
% % %%                %% % %
% % %%%%% %%%  %%% %%%%% % %
% % %%%%% %      % %%%%% % %
% % %%    %      %    %% % %
% % %% %% %      % %% %% % %
% % %% %% %%%%%%%% %% %% % %
% %    %%          %%    % %
% % %% %%%%% %% %%%%% %% % %
%%% %% %%%%% %% %%%%% %% %%%
%   %%       %%       %%   %
%%%%%% %% %%%%%%%% %% %%%%%%
%%%%%% %% %%%%%%%% %% %%%%%%
%      %%          %%      %
% %% %%%% %%%%%%%% %%%% %% %
% %% %%%% %%%%%%%% %%%% %% %
% %%   %%    %%    %%   %% %
% %%%% %% %% %% %% %% %%%% %
% %%%% %% %% %% %% %% %%%% %
%.        %% P  %%        .%
%%%%%%%%%%%%%%%%%%%%%%%%%%%%