%%%%%%%%%%%%%%%%%%%%%%%%%%%%
%.                        .%
% %%%%%%% %%%%%%%% %%%%%%% %
% %%%%%%% %%%%%%%% %%%%%%% %
%   %%    %%    %%    %%   %
%%% %% %% %% %% %% %% %% %%%
%%% %% %% %% %% %% %% %% %%%
%   %% %% %% %% %% %% %%   %
%%% %% %%    %%    %% %% %%%
% % %% %% %%%%%%%% %% %% % %
% % %% %% %%%%%%%% %% %% % %
% %                      % %
% % %%%%% %%%  %%% %%%%% % %
% % %%%%% %      % %%%%% % %
% %    %% %      % %%    % %
% % %% %% %      % %% %% % %
%%% %% %% %%%%%%%% %% %% %%%
%   %%                %%   %
% %%%% %% %%%%%%%% %% %%%% %
% %%%% %% %%%%%%%% %% %%%% %
%      %%    %%    %%      %
%%%% %%%% %% %% %% %%%% %%%%
%  % %%%% %% %% %% %%%% %  %
%  %      %%    %%      %  %
%  % %% %%%% %% %%%% %% %  %
%%%% %% %%%% %% %%%% %% %%%%
%    %%      %%      %%    %
% %%%%% %% %%%%%% %% %%%%% %
% %%%%% %% %%%%%% %% %%%%% %
%.      %%   P    %%      .%
%%%%%%%%%%%%%%%%%%%%%%%%%%%%