%%%%%%%%%%%%%%%%%%%%%%%%%%%%
%.                        .%
% %%%%%%% %%%%%%%% %%%%%%% %
% %%%%%%% %%%%%%%% %%%%%%% %
%   %%    %%    %%    %%   %
%%% %% %% %% %% %% %% %% %%%
% % %% %% %% %% %% %% %% % %
% % %% %% %% %% %% %% %% % %
% %    %%    %%    %%    % %
% % %%%%% %%%%%%%% %%%%% % %
%%% %%%%% %%%%%%%% %%%%% %%%
%      %%          %%      %
%%% %% %% %%%  %%% %% %% %%%
%%% %% %% %      % %% %% %%%
%   %%    %      %    %%   %
% %%%% %% %      % %% %%%% %
% %%%% %% %%%%%%%% %% %%%% %
%      %%          %%      %
%%%% %%%% %%%%%%%% %%%% %%%%
%  % %%%% %%%%%%%% %%%% %  %
%  %         %%         %  %
%  % %%%%%%% %% %%%%%%% %  %
%%%% %%%%%%% %% %%%%%%% %%%%
%         %%    %%         %
% %% %%%% %% %% %% %%%% %% %
% %% %%%% %% %% %% %%%% %% %
% %%   %%    %%    %%   %% %
% %%%% %% %%%%%%%% %% %%%% %
% %%%% %% %%%%%%%% %% %%%% %
%.           P            .%
%%%%%%%%%%%%%%%%%%%%%%%%%%%%