%%%%%%%%%%%%%%%%%%%%%%%%%%%%
%.     %%          %%     .%
% %%%% %% %%%%%%%% %% %%%% %
% %%%% %% %%%%%%%% %% %%%% %
%   %%       %%       %%   %
%%% %% %% %% %% %% %% %% %%%
% % %% %% %% %% %% %% %% % %
%%% %% %% %% %% %% %% %% %%%
%      %% %%    %% %%      %
%%% %%%%% %%%%%%%% %%%%% %%%
%%% %%%%% %%%%%%%% %%%%% %%%
%                          %
% %%%%%%% %%%  %%% %%%%%%% %
% %%%%%%% %      % %%%%%%% %
%   %%    %      %    %%   %
%%% %% %% %      % %% %% %%%
% % %% %% %%%%%%%% %% %% % %
% %    %%          %%    % %
% % %% %%%%% %% %%%%% %% % %
%%% %% %%%%% %% %%%%% %% %%%
%   %% %%    %%    %% %%   %
% %%%% %% %%%%%%%% %% %%%% %
% %%%% %% %%%%%%%% %% %%%% %
%                          %
% %%%%%%%%%% %% %%%%%%%%%% %
% %%%%%%%%%% %% %%%%%%%%%% %
%      %%    %%    %%      %
% %%%% %% %%%%%%%% %% %%%% %
% %%%% %% %%%%%%%% %% %%%% %
%.           P            .%
%%%%%%%%%%%%%%%%%%%%%%%%%%%%