%%%%%%%%%%%%%%%%%%%%%%%%%%%%
%.     %%          %%     .%
% %%%% %% %%%%%%%% %% %%%% %
% %%%% %% %%%%%%%% %% %%%% %
% %%         %%         %% %
% %% %%%% %% %% %% %%%% %% %
% %% %%%% %% %% %% %%%% %% %
%      %% %% %% %% %%      %
% %%%% %% %%    %% %% %%%% %
% %  % %% %%%%%%%% %% %  % %
% %%%% %% %%%%%%%% %% %%%% %
%                          %
% %% %%%% %%%  %%% %%%% %% %
% %% %%%% %      % %%%% %% %
% %%   %% %      % %%   %% %
% %%%% %% %      % %% %%%% %
% %%%% %% %%%%%%%% %% %%%% %
%                          %
%%% %%%%% %%%%%%%% %%%%% %%%
%%% %%%%% %%%%%%%% %%%%% %%%
%      %%    %%    %%      %
%%% %% %% %% %% %% %% %% %%%
%%% %% %% %% %% %% %% %% %%%
%   %%    %%    %%    %%   %
% %%%% %% %%%%%%%% %% %%%% %
% %%%% %% %%%%%%%% %% %%%% %
%      %%          %%      %
% %%%%%%%%%% %% %%%%%%%%%% %
% %%%%%%%%%% %% %%%%%%%%%% %
%.           P            .%
%%%%%%%%%%%%%%%%%%%%%%%%%%%%