%%%%%%%%%%%%%%%%%%%%%%%%%%%%
%.                        .%
% %%%% %% %%%%%%%% %% %%%% %
% %  % %% %%%%%%%% %% %  % %
% %%%% %% %%    %% %% %%%% %
%      %% %% %% %% %%      %
% %% %%%% %% %% %% %%%% %% %
% %% %%%% %% %% %% %%%% %% %
% %%   %%    %%    %%   %% %
% %%%% %% %%%%%%%% %% %%%% %
% %%%% %% %%%%%%%% %% %%%% %
%                          %
%%% %% %% %%%  %%% %% %% %%%
%%% %% %% %      % %% %% %%%
%   %% %% %      % %% %%   %
%%%%%% %% %      % %% %%%%%%
%%%%%% %% %%%%%%%% %% %%%%%%
%   %% %%          %% %%   %
%%% %% %%%%% %% %%%%% %% %%%
%%% %% %%%%% %% %%%%% %% %%%
%      %%    %%    %%      %
% %%%% %% %%%%%%%% %% %%%% %
% %%%% %% %%%%%%%% %% %%%% %
%                          %
% %% %%%%%%% %% %%%%%%% %% %
% %% %%%%%%% %% %%%%%%% %% %
% %%    %%   %%   %%    %% %
% %%%%% %% %%%%%% %% %%%%% %
% %%%%% %% %%%%%% %% %%%%% %
%.      %%   P    %%      .%
%%%%%%%%%%%%%%%%%%%%%%%%%%%%