%%%%%%%%%%%%%%%%%%%%%%%%%%%%
%.                        .%
% %% %%%%%%% %% %%%%%%% %% %
% %% %%%%%%% %% %%%%%%% %% %
% %%   %%    %%    %%   %% %
% %%%% %% %%%%%%%% %% %%%% %
% %%%% %% %%%%%%%% %% %%%% %
% %%                    %% %
% %% %%%% %%%%%%%% %%%% %% %
% %% %%%% %      % %%%% %% %
%      %% %%%%%%%% %%      %
% %%%% %%          %% %%%% %
% %  % %% %%%  %%% %% %  % %
% %%%% %% %      % %% %%%% %
%         %      %         %
% %%%%%%% %      % %%%%%%% %
% %%%%%%% %%%%%%%% %%%%%%% %
%   %%                %%   %
%%% %% %% %%%%%%%% %% %% %%%
%%% %% %% %%%%%%%% %% %% %%%
%      %%    %%    %%      %
% %%%% %%%%% %% %%%%% %%%% %
% %%%% %%%%% %% %%%%% %%%% %
%   %%                %%   %
%%% %% %% %%%%%%%% %% %% %%%
%%% %% %% %%%%%%%% %% %% %%%
%      %%    %%    %%      %
% %%%%%%%%%% %% %%%%%%%%%% %
% %%%%%%%%%% %% %%%%%%%%%% %
%.           P            .%
%%%%%%%%%%%%%%%%%%%%%%%%%%%%