%%%%%%%%%%%%%%%%%%%%%%%%%%%%
%.                        .%
% %%%% %% %%%%%%%% %% %%%% %
% %%%% %% %%%%%%%% %% %%%% %
% %%   %%          %%   %% %
% %% %%%% %%%%%%%% %%%% %% %
% %% %%%% %%%%%%%% %%%% %% %
%            %%            %
% %%%% %%%%% %% %%%%% %%%% %
% %%%% %   % %% %   % %%%% %
%   %% %%%%% %% %%%%% %%   %
%%% %%                %% %%%
%%% %% %% %%%  %%% %% %% %%%
%      %% %      % %%      %
% %%%% %% %      % %% %%%% %
% %%%% %% %      % %% %%%% %
%   %% %% %%%%%%%% %% %%   %
%%% %%                %% %%%
% % %% %% %%%%%%%% %% %% % %
% % %% %% %%%%%%%% %% %% % %
% %    %%    %%    %%    % %
% % %% %%%%% %% %%%%% %% % %
%%% %% %%%%% %% %%%%% %% %%%
%   %% %%          %% %%   %
%%% %% %% %%%%%%%% %% %% %%%
%%% %% %% %%%%%%%% %% %% %%%
%   %%       %%       %%   %
% %%%%%%% %% %% %% %%%%%%% %
% %%%%%%% %% %% %% %%%%%%% %
%.        %% P  %%        .%
%%%%%%%%%%%%%%%%%%%%%%%%%%%%