%%%%%%%%%%%%%%%%%%%%%%%%%%%%
%.           %%           .%
% %%%% %%%%% %% %%%%% %%%% %
% %%%% %%%%% %% %%%%% %%%% %
%   %% %%    %%    %% %%   %
%%% %% %% %%%%%%%% %% %% %%%
% % %% %% %%%%%%%% %% %% % %
% %    %%          %%    % %
% % %% %% %%%%%%%% %% %% % %
% % %% %% %      % %% %% % %
% % %% %% %%%%%%%% %% %% % %
% % %%                %% % %
% % %%%%% %%%  %%% %%%%% % %
% % %%%%% %      % %%%%% % %
% % %%    %      %    %% % %
% % %% %% %      % %% %% % %
% % %% %% %%%%%%%% %% %% % %
% %    %%          %%    % %
% % %%%%%%%% %% %%%%%%%% % %
%%% %%%%%%%% %% %%%%%%%% %%%
%      %%    %%    %%      %
%%% %% %% %%%%%%%% %% %% %%%
%%% %% %% %%%%%%%% %% %% %%%
%   %%                %%   %
% %%%% %%%%% %% %%%%% %%%% %
% %%%% %%%%% %% %%%%% %%%% %
%      %%    %%    %%      %
% %%%% %% %%%%%%%% %% %%%% %
% %%%% %% %%%%%%%% %% %%%% %
%.           P            .%
%%%%%%%%%%%%%%%%%%%%%%%%%%%%