%%%%%%%%%%%%%%%%%%%%%%%%%%%%
%.                        .%
% %% %%%%% %%%%%% %%%%% %% %
% %% %   % %    % %   % %% %
% %% %%%%% %%%%%% %%%%% %% %
% %%                    %% %
% %%%%% %% %%%%%% %% %%%%% %
% %%%%% %% %%%%%% %% %%%%% %
% %%    %%   %%   %%    %% %
% %% %% %%%% %% %%%% %% %% %
%    %% %%%% %% %%%% %%    %
% %% %%              %% %% %
% %% %%%% %%%  %%% %%%% %% %
% %% %%%% %      % %%%% %% %
% %%      %      %      %% %
% %%%% %% %      % %% %%%% %
% %%%% %% %%%%%%%% %% %%%% %
% %%   %%          %%   %% %
% %% %%%%%%% %% %%%%%%% %% %
% %% %%%%%%% %% %%%%%%% %% %
%      %%    %%    %%      %
%%%%%% %% %%%%%%%% %% %%%%%%
%%%%%% %% %%%%%%%% %% %%%%%%
%   %%                %%   %
%%% %% %% %%%%%%%% %% %% %%%
%%% %% %% %%%%%%%% %% %% %%%
%      %%    %%    %%      %
% %%%%%%% %% %% %% %%%%%%% %
% %%%%%%% %% %% %% %%%%%%% %
%.        %% P  %%        .%
%%%%%%%%%%%%%%%%%%%%%%%%%%%%