%%%%%%%%%%%%%%%%%%%%%%%%%%%%
%.                        .%
% %%%% %% %%%%%%%% %% %%%% %
% %  % %% %      % %% %  % %
% %  % %% %%%%%%%% %% %  % %
% %  % %%          %% %  % %
% %  % %% %%%%%%%% %% %  % %
% %%%% %% %%%%%%%% %% %%%% %
%      %%    %%    %%      %
% %%%% %%%%% %% %%%%% %%%% %
% %%%% %%%%% %% %%%%% %%%% %
%                          %
% %% %%%% %%%  %%% %%%% %% %
% %% %%%% %      % %%%% %% %
% %%   %% %      % %%   %% %
% %%%% %% %      % %% %%%% %
% %%%% %% %%%%%%%% %% %%%% %
%                          %
%%% %% %%%%% %% %%%%% %% %%%
%%% %% %%%%% %% %%%%% %% %%%
%   %% %%    %%    %% %%   %
%%%%%% %% %%%%%%%% %% %%%%%%
%%%%%% %% %%%%%%%% %% %%%%%%
%                          %
% %% %%%%%%% %% %%%%%%% %% %
% %% %%%%%%% %% %%%%%%% %% %
% %%    %%   %%   %%    %% %
% %%%%% %% %%%%%% %% %%%%% %
% %%%%% %% %%%%%% %% %%%%% %
%.           P            .%
%%%%%%%%%%%%%%%%%%%%%%%%%%%%