%%%%%%%%%%%%%%%%%%%%%%%%%%%%
%.     %%          %%     .%
% %%%% %% %%%%%%%% %% %%%% %
% %  % %% %      % %% %  % %
% %%%% %% %%%%%%%% %% %%%% %
%                          %
% %%%% %% %%%%%%%% %% %%%% %
% %%%% %% %%%%%%%% %% %%%% %
%   %% %%    %%    %% %%   %
%%% %% %%%%% %% %%%%% %% %%%
% % %% %%%%% %% %%%%% %% % %
% %                      % %
% % %% %% %%%  %%% %% %% % %
%%% %% %% %      % %% %% %%%
%   %% %% %      % %% %%   %
%%%%%% %% %      % %% %%%%%%
%%%%%% %% %%%%%%%% %% %%%%%%
%   %% %%          %% %%   %
%%% %% %%%%% %% %%%%% %% %%%
% % %% %%%%% %% %%%%% %% % %
% %          %%          % %
% % %%%%% %%%%%%%% %%%%% % %
% % %%%%% %%%%%%%% %%%%% % %
% %    %%          %%    % %
% % %% %% %%%%%%%% %% %% % %
%%% %% %% %%%%%%%% %% %% %%%
%   %%    %%    %%    %%   %
% %%%%%%% %% %% %% %%%%%%% %
% %%%%%%% %% %% %% %%%%%%% %
%.           P            .%
%%%%%%%%%%%%%%%%%%%%%%%%%%%%